pac_name,affiliate,total,dem,repub,lean,year
Americans for a Republican Majority,Tom DeLay (R-Texas),1058355,0,1058355,Solidly Republican/Conservative,2002
PAC to the Future,Nancy Pelosi (D-Calif),1041150,1041150,0,Solidly Democrat/Liberal,2002
HILLPAC,Hillary Clinton (D-NY),837000,837000,0,Solidly Democrat/Liberal,2002
Keep Our Majority PAC,Dennis Hastert (R-Ill),778500,0,778500,Solidly Republican/Conservative,2002
New Millennium PAC,Robert Menendez (D-NJ),681500,681500,0,Solidly Democrat/Liberal,2002
AmeriPAC: The Fund for a Greater America,Steny H. Hoyer (D-Md),642500,642500,0,Solidly Democrat/Liberal,2002
Freedom Project,John Boehner (R-Ohio),641792,0,641792,Solidly Republican/Conservative,2002
Rely on Your Beliefs,Roy Blunt (R-Mo),631429,0,631429,Solidly Republican/Conservative,2002
Leadership PAC 2002,Michael G Oxley (R-Ohio),556400,0,556400,Solidly Republican/Conservative,2002
National Leadership PAC,Charles B. Rangel (D-NY),550500,550500,0,Solidly Democrat/Liberal,2002
Committee for the Preservation of Capitalism,Jim McCrery (R-La),532000,0,532000,Solidly Republican/Conservative,2002
Lone Star Fund,Martin Frost (D-Texas),531726,531726,0,Solidly Democrat/Liberal,2002
Together for Our Majority,Tom Reynolds (R-NY),519987,0,519987,Solidly Republican/Conservative,2002
DASHPAC,Tom Daschle (D-SD),476000,476000,0,Solidly Democrat/Liberal,2002
Bayou Leader PAC,Billy Tauzin (R-La),440470,0,440470,Solidly Republican/Conservative,2002
Republican Majority Fund,Don Nickles (R-Okla),405793,0,405793,Solidly Republican/Conservative,2002
Future Leaders PAC,Jerry Lewis (R-Calif),363000,5000,358000,Solidly Republican/Conservative,2002
Congressional Majority Cmte,Bill Thomas (R-Calif),360500,0,360500,Solidly Republican/Conservative,2002
Effective Government Cmte,Richard A Gephardt (D-Mo),360000,360000,0,Solidly Democrat/Liberal,2002
New Republican Majority Fund,Trent Lott (R-Miss),360000,0,360000,Solidly Republican/Conservative,2002
Responsibility/Opportunity/Community PAC,Joe Lieberman (D-Conn),354822,354822,0,Solidly Democrat/Liberal,2002
Defend America PAC,Richard C. Shelby (R-Ala),330000,0,330000,Solidly Republican/Conservative,2002
Freedom Works PAC,Dick Armey (R-Texas),321240,0,321240,Solidly Republican/Conservative,2002
LA PAC,Henry A. Waxman (D-Calif),322000,322000,0,Solidly Democrat/Liberal,2002
American Success PAC,David Dreier (R-Calif),312500,0,312500,Solidly Republican/Conservative,2002
Americans for Responsible Leadership,Evan Bayh (D-Ind),308500,308500,0,Solidly Democrat/Liberal,2002
Volunteer PAC,Bill Frist (R-Tenn),306000,5000,301000,Solidly Republican/Conservative,2002
Help America's Leaders,Hal Rogers (R-Ky),285000,0,285000,Solidly Republican/Conservative,2002
America's Majority Trust,Rob Portman (R-Ohio),274526,0,274526,Solidly Republican/Conservative,2002
America's Foundation,Rick Santorum (R-Pa),264000,0,264000,Solidly Republican/Conservative,2002
Federal Victory Fund,Tom Davis (R-Va),251500,3000,248500,Solidly Republican/Conservative,2002
Searchlight Leadership Fund,Harry Reid (D-Nev),249962,249962,0,Solidly Democrat/Liberal,2002
New Jersey United,Jon S Corzine (D-NJ),247000,247000,0,Solidly Democrat/Liberal,2002
Re-Elect Freshmen of the Republican Majority,Jerry Weller (R-Ill),246887,0,246887,Solidly Republican/Conservative,2002
PAC for a Change,Barbara Boxer (D-Calif),237000,237000,0,Solidly Democrat/Liberal,2002
Sandhills PAC,Chuck Hagel (R-Neb),234500,5000,229500,Solidly Republican/Conservative,2002
Promoting Republicans You Can Elect,Deborah Pryce (R-Ohio),233000,0,233000,Solidly Republican/Conservative,2002
Committee for a Democratic Future,Rosa L DeLauro (D-Conn),223066,223066,0,Solidly Democrat/Liberal,2002
Good Government for America,George Allen (R-Va),207500,1000,206500,Solidly Republican/Conservative,2002
Bluegrass Cmte,Mitch McConnell (R-Ky),191000,0,191000,Solidly Republican/Conservative,2002
Senate Majority Fund,Jon L. Kyl (R-Ariz),186984,0,186984,Solidly Republican/Conservative,2002
Conservative Victory Fund,ex-Rep. Steven D Symms (R-Idaho),184674,0,184674,Solidly Republican/Conservative,2002
Senate Victory Fund,Thad Cochran (R-Miss),184597,0,184597,Solidly Republican/Conservative,2002
Northern Lights PAC,Ted Stevens (R-Alaska),180488,0,180488,Solidly Republican/Conservative,2002
New American Optimists,John Edwards (D-NC),179925,179925,0,Solidly Democrat/Liberal,2002
PETE PAC,Pete Sessions (R-Texas),177000,0,177000,Solidly Republican/Conservative,2002
Committee for a Livable Future,Earl Blumenauer (D-Ore),175575,175575,0,Solidly Democrat/Liberal,2002
Texas Freedom Fund,Joe Barton (R-Texas),169010,0,169010,Solidly Republican/Conservative,2002
Committee for Leadership & Progress,Nita M. Lowey (D-NY),167000,167000,0,Solidly Democrat/Liberal,2002
Committee for a Democratic Majority,Edward M. Kennedy (D-Mass),166858,166858,0,Solidly Democrat/Liberal,2002
21st Century PAC,Buck McKeon (R-Calif),157500,0,157500,Solidly Republican/Conservative,2002
Prairie PAC,Dick Durbin (D-Ill),155500,155500,0,Solidly Democrat/Liberal,2002
Pioneer PAC,Dave Hobson (R-Ohio),141326,0,141326,Solidly Republican/Conservative,2002
KPAC,Kay Bailey Hutchison (R-Texas),136272,0,136272,Solidly Republican/Conservative,2002
Solidarity PAC,George Miller (D-Calif),136000,136000,0,Solidly Democrat/Liberal,2002
Mainstream America PAC,John Breaux (D-La),131031,131031,0,Solidly Democrat/Liberal,2002
America Works PAC,Sherrod Brown (D-Ohio),129500,129500,0,Solidly Democrat/Liberal,2002
American Prosperity PAC,Randy (Duke) Cunningham (R-Calif),129500,0,129500,Solidly Republican/Conservative,2002
Campaign for America's Future,Orrin G. Hatch (R-Utah),125500,0,125500,Solidly Republican/Conservative,2002
First State PAC,Tom Carper (D-Del),119000,119000,0,Solidly Democrat/Liberal,2002
Alliance for the West,Larry Craig (R-Idaho),118845,0,118845,Solidly Republican/Conservative,2002
Ohio's 17 Star PAC,Mike DeWine (R-Ohio),112350,0,112350,Solidly Republican/Conservative,2002
Citizen Soldier Fund,John Kerry (D-Mass),111639,111639,0,Solidly Democrat/Liberal,2002
Leadership in the New Century,Blanche Lincoln (D-Ark),111500,111500,0,Solidly Democrat/Liberal,2002
Leadership 02,ex-V.P. Al Gore (D),110500,110500,0,Solidly Democrat/Liberal,2002
Glacier PAC,Max Baucus (D-Mont),108000,108000,0,Solidly Democrat/Liberal,2002
Majority Initiative-Keep Electing Repubs,Mike Rogers (R-Mich),105000,0,105000,Solidly Republican/Conservative,2002
Washington Fund,Jennifer Dunn (R-Wa),103000,0,103000,Solidly Republican/Conservative,2002
Committee for a United Republican Team,Curt Weldon (R-Pa),94000,0,94000,Solidly Republican/Conservative,2002
Back America's Conservatives PAC,Richard Baker (R-La),94000,0,94000,Solidly Republican/Conservative,2002
Next Century Fund,Richard Burr (R-NC),87200,0,87200,Solidly Republican/Conservative,2002
Friends of the Big Sky,Conrad Burns (R-Mont),86810,0,86810,Solidly Republican/Conservative,2002
Wisconsin Leadership PAC,F James Sensenbrenner Jr. (R-Wis),86000,1000,85000,Solidly Republican/Conservative,2002
M-PAC,Patty Murray (D-Wash),85000,85000,0,Solidly Democrat/Liberal,2002
American Liberty PAC,Bob Ney (R-Ohio),83500,0,83500,Solidly Republican/Conservative,2002
Congressional Leadership Fund (Cox),Christopher Cox (R-Calif),80500,0,80500,Solidly Republican/Conservative,2002
TEAM PAC,J D Hayworth (R-Ariz),80193,0,80193,Solidly Republican/Conservative,2002
Independent Action,Tom Harkin (D-Iowa),79050,79050,0,Solidly Democrat/Liberal,2002
Buckeye PAC,George V Voinovich (R-Ohio),79000,5000,74000,Solidly Republican/Conservative,2002
Great Plains Leadership Fund,Byron L. Dorgan (D-ND),77500,77500,0,Solidly Democrat/Liberal,2002
Committee for a Progressive Congress,David R Obey (D-Wis),76500,76500,0,Solidly Democrat/Liberal,2002
Citizens for a Competitive America,Fritz Hollings (D-SC),76000,76000,0,Solidly Democrat/Liberal,2002
Responsibility & Freedom Work PAC,Roger Wicker (R-Miss),74000,0,74000,Solidly Republican/Conservative,2002
Rhode Island PAC,Patrick J. Kennedy (D-RI),72500,72500,0,Solidly Democrat/Liberal,2002
DAKPAC,Kent Conrad (D-ND),72000,72000,0,Solidly Democrat/Liberal,2002
Matsui Leadership Fund,Robert T. Matsui (D-Calif),68500,68500,0,Solidly Democrat/Liberal,2002
Continuing a Majority Party Action Cmte,Dave Camp (R-Mich),67025,0,67025,Solidly Republican/Conservative,2002
Hispanic Unity USA,Loretta Sanchez (D-CA),67000,67000,0,Solidly Democrat/Liberal,2002
Building Our Bases (BOBS) PAC,ex-Rep. Robert L Livingston (R-La),66220,0,66220,Solidly Republican/Conservative,2002
Battle Born PAC,John Ensign (R-Nev),66000,0,66000,Solidly Republican/Conservative,2002
Impact (Schumer),Charles E. Schumer (D-NY),65000,65000,0,Solidly Democrat/Liberal,2002
Midnight Sun,Don Young (R-Alaska),62000,0,62000,Solidly Republican/Conservative,2002
District 20 Florida Federal PAC,Peter Deutsch (D-Fla),54500,54500,0,Solidly Democrat/Liberal,2002
Doing Our Nation's Service PAC,Don Sherwood (R-Pa),59250,0,59250,Solidly Republican/Conservative,2002
America's Leadership PAC,Deborah Ann Stabenow (D-Mich),56500,56500,0,Solidly Democrat/Liberal,2002
Fund for American Opportunity,ex-Sen. Spencer Abraham (R-Mich),55250,0,55250,Solidly Republican/Conservative,2002
Leadership 21,John Tanner (D-Tenn),55000,55000,0,Solidly Democrat/Liberal,2002
Paxon PAC,ex-Rep. Bill Paxon (R-NY),54750,500,54250,Solidly Republican/Conservative,2002
Education & Opportunity Fund,David Wu (D-Ore),51000,51000,0,Solidly Democrat/Liberal,2002
United in Freedom,John E Sweeney (R-NY),49500,0,49500,Solidly Republican/Conservative,2002
Restore America PAC,Sam Brownback (R-Kan),47500,2500,45000,Solidly Republican/Conservative,2002
Committee for Southwest Virginia,Rick Boucher (D-Va),44500,44500,0,Solidly Democrat/Liberal,2002
Superior California Fed Leadership Fund,John T. Doolittle (R-Calif),44000,0,44000,Solidly Republican/Conservative,2002
Leadership for America,Phil Gramm (R-Texas),43923,0,43923,Solidly Republican/Conservative,2002
Big Tent PAC,Arlen Specter (R-Pa),42000,0,42000,Solidly Republican/Conservative,2002
The Titans Fund,Harold E Ford Jr (D-Tenn),42000,42000,0,Solidly Democrat/Liberal,2002
People Helping People,Maxine Waters (D-Calif),38500,38500,0,Solidly Democrat/Liberal,2002
Friends of Bob Livingston PAC,ex-Rep. Robert L Livingston (R-La),38183,0,38183,Solidly Republican/Conservative,2002
GROWPAC,J C Watts Jr (R-Okla),37750,0,37750,Solidly Republican/Conservative,2002
Renew America PAC,ex-Sen. Alfonse M D'Amato (R-NY),35700,5000,30700,Solidly Republican/Conservative,2002
Americans for Common Sense Government,Christopher Shays (R-Conn),35000,0,35000,Solidly Republican/Conservative,2002
Florida Republican Leadership PAC,Mark Foley (R-Fla),34500,0,34500,Solidly Republican/Conservative,2002
Straight Talk America,John McCain (R-Ariz),33463,0,33463,Solidly Republican/Conservative,2002
ZackPAC,Robert Wexler (D-Fla),32500,32500,0,Solidly Democrat/Liberal,2002
Northwest Leadership PAC,ex-Sen. Slade Gorton (R-Wash),32500,0,32500,Solidly Republican/Conservative,2002
Integrity Fund,Melissa Hart (R-Pa),31160,0,31160,Solidly Republican/Conservative,2002
Fund for a Responsible Future,ex-Rep. Thomas J Bliley Jr (R-Va),29665,1000,28665,Solidly Republican/Conservative,2002
Vision for America,ex-Rep. Tillie Fowler (R-Fla),29481,1000,28481,Solidly Republican/Conservative,2002
Team Majority,Nancy Pelosi (D-Calif),29000,29000,0,Solidly Democrat/Liberal,2002
Southern California Fund,Brad Sherman (D-Calif),28500,28500,0,Solidly Democrat/Liberal,2002
Common Sense Leadership Fund,Saxby Chambliss (R-Ga),26587,0,26587,Solidly Republican/Conservative,2002
Gumbo PAC,Chris John (D-La),26554,26554,0,Solidly Democrat/Liberal,2002
Milead Fund,Peter Hoekstra (R-Mich),26500,0,26500,Solidly Republican/Conservative,2002
Carolyn's PAC,Carolyn B. Maloney (D-NY),26000,26000,0,Solidly Democrat/Liberal,2002
Fund for a Conservative Future,James M. Inhofe (R-Okla),26000,0,26000,Solidly Republican/Conservative,2002
21st Century Majority Fund,Johnny Isakson (R-GA),25000,0,25000,Solidly Republican/Conservative,2002
Silver State 21st Century PAC,Shelley Berkley (D-Nev),24250,24250,0,Solidly Democrat/Liberal,2002
Fund for a Healthy America,Gov. Howard Dean (D-Vt),23000,23000,0,Solidly Democrat/Liberal,2002
Summit PAC,Alan B Mollohan (D-Wva),23000,23000,0,Solidly Democrat/Liberal,2002
Peace Through Strength PAC,Duncan Hunter (R-Calif),22500,0,22500,Solidly Republican/Conservative,2002
Fund for a Free Market America,Phil Crane (R-Ill),22028,0,22028,Solidly Republican/Conservative,2002
Sacramento Valley Leadership Fund,Doug Ose (R-Calif),22000,0,22000,Solidly Republican/Conservative,2002
Victory PAC,C. W. Bill Young (R-Fla),21000,0,21000,Solidly Republican/Conservative,2002
Democrats for the Future,Ellen O. Tauscher (D-Calif),22000,22000,0,Solidly Democrat/Liberal,2002
Great Dane PAC,Jim Nussle (R-Iowa),21729,0,21729,Solidly Republican/Conservative,2002
Build America PAC,Gregory W. Meeks (D-NY),20000,20000,0,Solidly Democrat/Liberal,2002
Carolina Majority PAC,Joe Wilson (R-SC),20500,0,20500,Solidly Republican/Conservative,2002
Nebraska Leadership PAC,Ben Nelson (D-Neb),20500,20500,0,Solidly Democrat/Liberal,2002
Time Future Inc,ex-Sen. Bill Bradley (D-NJ),20500,20500,0,Solidly Democrat/Liberal,2002
American Leadership Council,Joe Knollenberg (R-Mich),20099,0,20099,Solidly Republican/Conservative,2002
Changing Tide Cmte,Wayne Allard (R-Colo),20000,0,20000,Solidly Republican/Conservative,2002
TRUST PAC,Fred Upton (R-Mich),19500,0,19500,Solidly Republican/Conservative,2002
13th Colony Leadership Cmte,Jack Kingston (R-Ga),18500,0,18500,Solidly Republican/Conservative,2002
Democracy Believers PAC,Lincoln Diaz-Balart (R-Fla),19000,0,19000,Solidly Republican/Conservative,2002
Pete's PAC,Pete V. Domenici (R-NM),19000,0,19000,Solidly Republican/Conservative,2002
Victory in November Election PAC,Mike Thompson (D-Calif),18245,18245,0,Solidly Democrat/Liberal,2002
Hoosier PAC,Dan Burton (R-Ind),18000,0,18000,Solidly Republican/Conservative,2002
21st Century Freedom PAC,Gov. George E. Pataki (R-NY),18000,0,18000,Solidly Republican/Conservative,2002
Evergreen Fund,David E Bonior (D-Mich),17726,17726,0,Solidly Democrat/Liberal,2002
Heart PAC,Todd Tiahrt (R-Kan),17000,0,17000,Solidly Republican/Conservative,2002
Show-Me Fund,Ike Skelton (D-Mo),17000,17000,0,Solidly Democrat/Liberal,2002
Salt PAC,"John ""Chip"" Saltsman Jr.",17000,0,17000,Solidly Republican/Conservative,2002
WELPAC,Ernie Fletcher (R-Ky),16500,0,16500,Solidly Republican/Conservative,2002
Future PAC,William J Jefferson (D-La),15000,15000,0,Solidly Democrat/Liberal,2002
American Spirit,Jesse Helms (R-NC),14500,0,14500,Solidly Republican/Conservative,2002
Live Free or Die,Bob Smith (R-NH),14350,0,14350,Solidly Republican/Conservative,2002
Progressive Choices PAC,Jan Schakowsky (D-Ill),14152,14152,0,Solidly Democrat/Liberal,2002
"Jobs, Opportunities & Education PAC",Joseph Crowley (D-NY),14000,14000,0,Solidly Democrat/Liberal,2002
New Century Project,ex-Rep. John R Kasich (R-Ohio),13500,0,13500,Solidly Republican/Conservative,2002
Committee for Democratic Action,ex-Sen. Howard M Metzenbaum (D-Ohio),13200,13200,0,Solidly Democrat/Liberal,2002
Rough Rider PAC,ex-Rep. Rick A Lazio (R-NY),13000,0,13000,Solidly Republican/Conservative,2002
New Majority Project,ex-Gov. James Gilmore (R-Va),12200,0,12200,Solidly Republican/Conservative,2002
Life & Liberty PAC (Keyes),Alan L Keyes (R-),12000,0,12000,Solidly Republican/Conservative,2002
Western Action PAC,Craig Thomas (R-Wyo),11000,0,11000,Solidly Republican/Conservative,2002
Prosperity PAC,Paul Ryan (R-Wis),11000,0,11000,Solidly Republican/Conservative,2002
Americans for Law & Liberty,Asa Hutchinson (R-Ark),10662,0,10662,Solidly Republican/Conservative,2002
American Dream PAC,Henry Bonilla (R-Texas),10500,0,10500,Solidly Republican/Conservative,2002
Impact America,Gordon H Smith (R-Ore),10119,0,10119,Solidly Republican/Conservative,2002
Continue the Majority,ex-Rep. Bill McCollum (R-Fla),10000,0,10000,Solidly Republican/Conservative,2002
House BackPAC,Sander Levin (D-Mich),10000,10000,0,Solidly Democrat/Liberal,2002
West PAC,Diana DeGette (D-Colo),10000,10000,0,Solidly Democrat/Liberal,2002
Prosperity Helps Inspire Liberty PAC,Phil English (R-Pa),9500,0,9500,Solidly Republican/Conservative,2002
Pastor's PAC,Ed Pastor (D-Ariz),9000,9000,0,Solidly Democrat/Liberal,2002
Bob Barr Leadership Fund,Bob Barr (R-Ga),9000,0,9000,Solidly Republican/Conservative,2002
Patriot PAC (Rogan),ex-Rep. James E Rogan (R-Calif),8100,0,8100,Solidly Republican/Conservative,2002
California Aggressive Leadership PAC,Joe Baca (D-Calif),8000,8000,0,Solidly Democrat/Liberal,2002
Van Hilleary PAC,Van Hilleary (R-Tenn),8000,0,8000,Solidly Republican/Conservative,2002
TEX-USA Fund,Chet Edwards (D-Texas),7000,7000,0,Solidly Democrat/Liberal,2002
Liberty PAC (Ron Paul),Ron Paul (R-Texas),7000,0,7000,Solidly Republican/Conservative,2002
Advance the Majority PAC,Jeff Miller (R-Fla),6829,0,6829,Solidly Republican/Conservative,2002
Abraham Lincoln Leadership PAC,Ray LaHood (R-Ill),6000,0,6000,Solidly Republican/Conservative,2002
Hawkeye PAC,Chuck Grassley (R-Iowa),6000,0,6000,Solidly Republican/Conservative,2002
Badger PAC,Ron Kind (D-Wis),6000,6000,0,Solidly Democrat/Liberal,2002
Hudson Valley Victory Fund,Sue Kelly (R-NY),6000,0,6000,Solidly Republican/Conservative,2002
William Penn Leadership Fund,James C Greenwood (R-Pa),6000,0,6000,Solidly Republican/Conservative,2002
Rad PAC,George Radanovich (R-Calif),6000,0,6000,Solidly Republican/Conservative,2002
San Diego PAC,Bob Filner (D-Calif),5500,5500,0,Solidly Democrat/Liberal,2002
Leadership of Today & Tomorrow,Xavier Becerra (D-Calif),5229,5229,0,Solidly Democrat/Liberal,2002
PA PAC,Frank Mascara (D-Pa),5200,5200,0,Solidly Democrat/Liberal,2002
Mary's PAC,Mary Bono (R-Calif),5000,0,5000,Solidly Republican/Conservative,2002
Fund for All Americans,ex-Gov. Thomas Kean (R-NJ),5000,0,5000,Solidly Republican/Conservative,2002
America's Leaders' Fund,ex-Rep. Dan Rostenkowski (D-Ill),5000,5000,0,Solidly Democrat/Liberal,2002
BACKPAC:Bldg America's Conscience & Kids,ex-Sen. Bob Kerrey (D-Neb),5000,5000,0,Solidly Democrat/Liberal,2002
Oregon Smith Fund,ex-Rep. Bob Smith (R-Ore),4750,0,4750,Solidly Republican/Conservative,2002
Millennium Leadership PAC,Alcee L. Hastings (D-Fla),4221,4221,0,Solidly Democrat/Liberal,2002
White Mountain PAC,Judd Gregg (R-NH),4000,0,4000,Solidly Republican/Conservative,2002
Join Our Efforts PAC,Joseph M. Hoeffel (D-Pa),4000,4000,0,Solidly Democrat/Liberal,2002
Posthumus Victory Fund USA,Lt. Gov. Dick Posthumus (R-MI),3050,0,3050,Solidly Republican/Conservative,2002
Invest for America,ex-Rep. William P Baker (R-Calif),3000,0,3000,Solidly Republican/Conservative,2002
Roz McGrath for Assembly,State Assembly Cand. Roz McGrath (D-CA),3000,3000,0,Solidly Democrat/Liberal,2002
SCIPAC,Vernon J. Ehlers (R-Mich),3000,0,3000,Solidly Republican/Conservative,2002
Empower People PAC,Ted Strickland (D-Ohio),3000,3000,0,Solidly Democrat/Liberal,2002
World Record Fund,Jim Ryun (R-Kan),3000,0,3000,Solidly Republican/Conservative,2002
Keystone Fund,Mike Doyle (D-Pa),3000,3000,0,Solidly Democrat/Liberal,2002
Ed XL PAC,Hoekstra (R-Mich)/Schaffer (R-Colo),2500,0,2500,Solidly Republican/Conservative,2002
Leadership for America's Future,Steve Largent (R-Okla),2500,0,2500,Solidly Republican/Conservative,2002
Chesapeake PAC (Wynn),Albert R. Wynn (D-Md),2000,2000,0,Solidly Democrat/Liberal,2002
Common Sense Common Solutions,Kay Granger (R-Texas),2000,0,2000,Solidly Republican/Conservative,2002
Leadership for the Future,ex-Sen. Jim Sasser (D-Tenn),2000,2000,0,Solidly Democrat/Liberal,2002
Spirit of Democratic Capitalism Fund,Cliff Stearns (R-Fla),2000,0,2000,Solidly Republican/Conservative,2002
Progressive Leadership for America,Dennis Moore (D-Kan),2000,2000,0,Solidly Democrat/Liberal,2002
Bully PAC,ex-Gov. Ed Schafer (R-ND),2000,0,2000,Solidly Republican/Conservative,2002
Committee for a Democratic Consensus,ex-Sen. Alan Cranston (D-Calif),1748,1748,0,Solidly Democrat/Liberal,2002
Archer's Arrows,ex-Mayor Dennis Archer (D-Detroit),1700,1700,0,Solidly Democrat/Liberal,2002
John J Cullerton Federal Cmte,State Sen. John J. Cullerton (D-Ill),1150,1150,0,Solidly Democrat/Liberal,2002
Moving America Forward,Bill Nelson (D-Fla),1100,1100,0,Solidly Democrat/Liberal,2002
Committee for Common Sense in Government,Bud Cramer (D-Ala),1000,1000,0,Solidly Democrat/Liberal,2002
Excelsior PAC (Houghton),Amo Houghton (R-NY),1000,0,1000,Solidly Republican/Conservative,2002
Storm Chasers,Steve Buyer (R-Ind),1000,0,1000,Solidly Republican/Conservative,2002
House Majority Fund,John Lewis (D-Ga),1000,1000,0,Solidly Democrat/Liberal,2002
Secure America's Majority PAC,Sam Johnson (R-Texas),1000,0,1000,Solidly Republican/Conservative,2002
Prairie Leadership Cmte,Tim Johnson (D-SD),1000,1000,0,Solidly Democrat/Liberal,2002
Kentucky PAC,Anne M Northup (R-Ky),1000,0,1000,Solidly Republican/Conservative,2002
Pro-Liberty PAC,Dana Rohrabacher (R-Calif),565,0,565,Solidly Republican/Conservative,2002
ApplePAC,ex-Rep. Douglas Applegate (D-Ohio),500,500,0,Solidly Democrat/Liberal,2002
TLC PAC,Karen L Thurman (D-Fla),500,500,0,Solidly Democrat/Liberal,2002
Friends of Sophie Masloff,ex-Mayor Sophie Masloff (D-Pittsburgh),375,375,0,Solidly Democrat/Liberal,2002
Hon Anne P Petera Natl Committeewoman VA,Natl Committeewoman Anne Petera (R-VA),100,0,100,Solidly Republican/Conservative,2002
