pac_name,affiliate,total,dem,repub,lean,year
Majority Cmte PAC,Kevin McCarthy (R-Calif),2450100,100,2450000,Solidly Republican/Conservative,2020
Huck PAC,ex-Gov. Mike Huckabee (R-),1867800,0,1867800,Solidly Republican/Conservative,2020
Frontline USA,Adam Schiff (D-Calif),1712462,1707462,5000,Solidly Democrat/Liberal,2020
Eye of the Tiger PAC,Steve Scalise (R-La),1521500,0,1521500,Solidly Republican/Conservative,2020
AmeriPAC: The Fund for a Greater America,Steny H Hoyer (D-Md),1320450,1310450,10000,Solidly Democrat/Liberal,2020
PAC to the Future,Nancy Pelosi (D-Calif),1290000,1290000,0,Solidly Democrat/Liberal,2020
Jobs Education & Families First,Hakeem Jeffries (D-NY),794500,787000,7500,Solidly Democrat/Liberal,2020
BRIDGE PAC,James E Clyburn (D-SC),701000,698500,2500,Solidly Democrat/Liberal,2020
Innovation PAC,Patrick McHenry (R-NC),653500,0,653500,Solidly Republican/Conservative,2020
CherPAC,Cheri Bustos (D-Ill),583000,585500,-2500,Solidly Democrat/Liberal,2020
CMR PAC,Cathy McMorris Rodgers (R-Wash),547000,0,547000,Solidly Republican/Conservative,2020
House Conservatives Fund,Mike Johnson (R-La),505000,0,505000,Solidly Republican/Conservative,2020
Democrats Win Seats PAC,Debbie Wasserman Schultz (D-Fla),499000,499000,0,Solidly Democrat/Liberal,2020
Building Leadership & Inspiring New Enterprise,Blaine Luetkemeyer (R-Mo),486500,0,486500,Solidly Republican/Conservative,2020
Purpose PAC,Cory Booker (D-NJ),453000,450000,3000,Solidly Democrat/Liberal,2020
Off the Sidelines,Kirsten Gillibrand (D-NY),442500,442500,0,Solidly Democrat/Liberal,2020
E-PAC,Elise Stefanik (R-NY),450000,0,450000,Solidly Republican/Conservative,2020
Making America Prosperous,Kevin Brady (R-Texas),430000,0,430000,Solidly Republican/Conservative,2020
Shore PAC,Frank Pallone Jr. (D-NJ),410500,410500,0,Solidly Democrat/Liberal,2020
Committee for a Democratic Future,Rosa L DeLauro (D-Conn),392500,392500,0,Solidly Democrat/Liberal,2020
"Jobs, Opportunity & New Ideas PAC",Joni Ernst (R-Iowa),395000,0,395000,Solidly Republican/Conservative,2020
COLE PAC,Tom Cole (R-Okla),390120,0,390120,Solidly Republican/Conservative,2020
America Works PAC,Sherrod Brown (D-Ohio),375500,375500,0,Solidly Democrat/Liberal,2020
Southern California Fund,Brad Sherman (D-Calif),373000,369500,3500,Solidly Democrat/Liberal,2020
Electing Majority Making Effective Republicans,Tom Emmer (R-Minn),372000,0,372000,Solidly Republican/Conservative,2020
Rely on Your Beliefs,Roy Blunt (R-Mo),370000,0,370000,Solidly Republican/Conservative,2020
Freedom Fund,Mike Crapo (R-Idaho),367500,0,367500,Solidly Republican/Conservative,2020
Republican Majority Fund,Tom Cotton (R-Ark),363063,0,363063,Solidly Republican/Conservative,2020
Madison PAC (Neal),Richard E Neal (D-Mass),361500,361500,0,Solidly Democrat/Liberal,2020
Cowboy PAC,Liz Cheney (R-Wyo),358700,0,358700,Solidly Republican/Conservative,2020
Oceans PAC,Sheldon Whitehouse (D-RI),347000,347000,0,Solidly Democrat/Liberal,2020
Progressive Majority PAC,Pete Aguilar (D-Calif),341000,341000,0,Solidly Democrat/Liberal,2020
Promoting Our Republican Team PAC,Rob Portman (R-Ohio),345000,0,345000,Solidly Republican/Conservative,2020
Free State PAC,Jerry Moran (R-Kan),333500,0,333500,Solidly Republican/Conservative,2020
Reclaim America PAC,Marco Rubio (R-Fla),328750,0,328750,Solidly Republican/Conservative,2020
New Pioneers PAC,Greg Walden (R-Ore),324000,0,324000,Solidly Republican/Conservative,2020
Citizens for Prosperity in America Today,Pat Toomey (R-Pa),319654,0,319654,Solidly Republican/Conservative,2020
BackPAC,Don Beyer (D-Va),314500,314500,0,Solidly Democrat/Liberal,2020
The US Campaign Fund,John Sarbanes (D-Md),314658,314658,0,Solidly Democrat/Liberal,2020
M-PAC,Patty Murray (D-Wash),305500,305500,0,Solidly Democrat/Liberal,2020
Great Lakes PAC,Debbie Stabenow (D-Mich),302500,302500,0,Solidly Democrat/Liberal,2020
Evergreen PAC,Suzan DelBene (D-Wash),305000,305000,0,Solidly Democrat/Liberal,2020
Heartland Values PAC,John Thune (R-SD),307500,0,307500,Solidly Republican/Conservative,2020
Follow the North Star Fund,Amy Klobuchar (D-Minn),305500,305500,0,Solidly Democrat/Liberal,2020
Fair Shot PAC,Katherine Clark (D-Mass),300500,300500,0,Solidly Democrat/Liberal,2020
Continuing America's Strength & Security,Bill Cassidy (R-La),299100,0,299100,Solidly Republican/Conservative,2020
Oorah! PAC,Todd Young (R-Ind),296916,0,296916,Solidly Republican/Conservative,2020
Lobo PAC,Martin Heinrich (D-NM),281000,281000,0,Solidly Democrat/Liberal,2020
Fund for America's Future,Lindsey Graham (R-SC),285500,0,285500,Solidly Republican/Conservative,2020
Guardian Fund,Jim Banks (R-Ind),285000,0,285000,Solidly Republican/Conservative,2020
Common Ground PAC,Tim Kaine (D-Va),274500,274500,0,Solidly Democrat/Liberal,2020
Prairie PAC,Dick Durbin (D-Ill),276500,276500,0,Solidly Democrat/Liberal,2020
Nebraska Sandhills PAC,Deb Fischer (R-Neb),280000,0,280000,Solidly Republican/Conservative,2020
Arkansas for Leadership,John Boozman (R-Ark),277500,0,277500,Solidly Republican/Conservative,2020
Keystone America PAC,Bob Casey (D-Pa),273000,273000,0,Solidly Democrat/Liberal,2020
Victory & Freedom PAC,Virginia Foxx (R-NC),275000,0,275000,Solidly Republican/Conservative,2020
Alamo PAC,John Cornyn (R-Texas),275000,0,275000,Solidly Republican/Conservative,2020
Motor City PAC,Gary Peters (D-Mich),269000,269000,0,Solidly Democrat/Liberal,2020
Blue Hen PAC,Chris Coons (D-Del),261474,261474,0,Solidly Democrat/Liberal,2020
Defend America PAC,Richard C Shelby (R-Ala),270000,0,270000,Solidly Republican/Conservative,2020
"Jobs, Freedom & Security PAC",Ted Cruz (R-Texas),267000,0,267000,Solidly Republican/Conservative,2020
Hawaii PAC,Brian Schatz (D-Hawaii),259000,259000,0,Solidly Democrat/Liberal,2020
Perimeter PAC,Tammy Duckworth (D-Ill),265750,265750,0,Solidly Democrat/Liberal,2020
Tomorrow Is Meaningful,Tim Scott (R-SC),261000,0,261000,Solidly Republican/Conservative,2020
Forward Together PAC,Mark Warner (D-Va),257500,257500,0,Solidly Democrat/Liberal,2020
Responsibility & Freedom Work PAC,Roger Wicker (R-Miss),255000,0,255000,Solidly Republican/Conservative,2020
Road to Freedom PAC,ex-Rep. Ed Royce (R-Calif),253000,0,253000,Solidly Republican/Conservative,2020
Bluegrass Cmte,Mitch McConnell (R-Ky),250000,0,250000,Solidly Republican/Conservative,2020
All for Our Country,Catherine Cortez Masto (D-Nev),243000,243000,0,Solidly Democrat/Liberal,2020
Prosperity Action,ex-Rep. Paul Ryan (R-Wis),247000,0,247000,Solidly Republican/Conservative,2020
Victory Now PAC,Chris Van Hollen (D-Md),246500,246500,0,Solidly Democrat/Liberal,2020
CA-LUV PAC,Pete Aguilar (D-Calif),244309,244309,0,Solidly Democrat/Liberal,2020
Ann PAC,Ann L Wagner (R-Mo),239250,0,239250,Solidly Republican/Conservative,2020
Greater Tomorrow PAC,Glenn Thompson (R-Pa),237500,0,237500,Solidly Republican/Conservative,2020
Committee for a Livable Future,Earl Blumenauer (D-Ore),227000,227000,0,Solidly Democrat/Liberal,2020
Hoosier PAC (Braun),Mike Braun (R-Ind),234500,0,234500,Solidly Republican/Conservative,2020
First State PAC,Tom Carper (D-Del),228000,228000,0,Solidly Democrat/Liberal,2020
Granite Values,Maggie Hassan (D-NH),222500,222500,0,Solidly Democrat/Liberal,2020
Smart Solutions PAC,Jacky Rosen (D-Nev),232500,232500,0,Solidly Democrat/Liberal,2020
Support to Ensure Victory Everywhere PAC,Steve Stivers (R-Ohio),229500,0,229500,Solidly Republican/Conservative,2020
Dakota PAC,John Hoeven (R-ND),230000,0,230000,Solidly Republican/Conservative,2020
Together Holding Our Majority PAC,Thom Tillis (R-NC),230000,0,230000,Solidly Republican/Conservative,2020
Badlands PAC,Kevin Cramer (R-ND),229500,0,229500,Solidly Republican/Conservative,2020
Lead Encourage Elect PAC,Mike Lee (R-Utah),226000,0,226000,Solidly Republican/Conservative,2020
Green Mountain PAC,Patrick Leahy (D-Vt),225500,225500,0,Solidly Democrat/Liberal,2020
Fostering Progress PAC,Bill Foster (D-Ill),225300,225300,0,Solidly Democrat/Liberal,2020
Democrats Reshaping America,Linda Sanchez (D-Calif),221200,221200,0,Solidly Democrat/Liberal,2020
MARSHA PAC,Marsha Blackburn (R-Tenn),220000,0,220000,Solidly Republican/Conservative,2020
Common Values PAC,John A Barrasso (R-Wyo),220000,0,220000,Solidly Republican/Conservative,2020
Jump Into Action for Conservatives To Keep Ideas,Jackie Walorski (R-Ind),219500,0,219500,Solidly Republican/Conservative,2020
First In Freedom PAC,Richard Hudson (R-NC),219400,0,219400,Solidly Republican/Conservative,2020
Lee PAC,Lee Zeldin (R-NY),215000,0,215000,Solidly Republican/Conservative,2020
Pelican PAC,John Kennedy (R-La),215000,0,215000,Solidly Republican/Conservative,2020
Impact (Schumer),Charles E Schumer (D-NY),200250,200250,0,Solidly Democrat/Liberal,2020
True North PAC,Dan Sullivan (R-Alaska),210000,0,210000,Solidly Republican/Conservative,2020
Pineapple PAC,Mazie K Hirono (D-Hawaii),202500,202500,0,Solidly Democrat/Liberal,2020
People's Voice PAC,Tammy Baldwin (D-Wis),207500,207500,0,Solidly Democrat/Liberal,2020
Jobs & Innovation Matter PAC,Jim Himes (D-Conn),206000,205000,1000,Solidly Democrat/Liberal,2020
Holding Onto Oregon's Priorities,Ron Wyden (D-Ore),205500,205500,0,Solidly Democrat/Liberal,2020
Wild & Wonderful PAC,Shelley Moore Capito (R-WVa),203500,0,203500,Solidly Republican/Conservative,2020
Blue Momentum PAC,Ted Lieu (D-Calif),203500,202500,1000,Solidly Democrat/Liberal,2020
Sensible American Solutions Supporting Everyone,Ben Sasse (R-Neb),201500,0,201500,Solidly Republican/Conservative,2020
Remedy PAC,Eric Swalwell (D-Calif),185500,185500,0,Solidly Democrat/Liberal,2020
Nutmeg PAC,Richard Blumenthal (D-Conn),200000,200000,0,Solidly Democrat/Liberal,2020
Narragansett Bay PAC,Jack Reed (D-RI),195500,195500,0,Solidly Democrat/Liberal,2020
PAC for a Change,ex-Sen. Barbara Boxer (D-Calif),193000,193000,0,Solidly Democrat/Liberal,2020
Sea Change Leadership PAC,Karen Bass (D-Calif),195150,195150,0,Solidly Democrat/Liberal,2020
Getting Stuff Done PAC,Kyrsten Sinema (D-Ariz),195000,195000,0,Solidly Democrat/Liberal,2020
Treasure State PAC,Jon Tester (D-Mont),193500,193500,0,Solidly Democrat/Liberal,2020
In the Arena PAC,French Hill (R-Ark),191000,0,191000,Solidly Republican/Conservative,2020
Texas Republicans United PAC,Michael McCaul (R-Texas),190600,0,190600,Solidly Republican/Conservative,2020
Lone Star Leadership PAC,Michael Burgess (R-Texas),190500,0,190500,Solidly Republican/Conservative,2020
Defense Economic Renewal Education & Knowledge PAC,Derek Kilmer (D-Wash),189500,189500,0,Solidly Democrat/Liberal,2020
One Georgia PAC,David Perdue (R-Ga),190000,0,190000,Solidly Republican/Conservative,2020
Next Century Fund,Richard Burr (R-NC),190000,0,190000,Solidly Republican/Conservative,2020
Big Sky Opportunity PAC,Steven Daines (R-Mont),188500,0,188500,Solidly Republican/Conservative,2020
Abraham Lincoln PAC,Darin LaHood (R-Ill),186500,0,186500,Solidly Republican/Conservative,2020
Lank PAC,James Lankford (R-Okla),185000,0,185000,Solidly Republican/Conservative,2020
American Defense & Military PAC,Adam Smith (D-Wash),182100,182100,0,Solidly Democrat/Liberal,2020
4MA Pac,Joe Kennedy III (D-Mass),181400,181400,0,Solidly Democrat/Liberal,2020
Gun Safety PAC,David Cicilline (D-RI),180500,180500,0,Solidly Democrat/Liberal,2020
Fund for a Conservative Future,James M Inhofe (R-Okla),180000,0,180000,Solidly Republican/Conservative,2020
Liberty Fund,Jaime Herrera Beutler (R-Wash),175500,1000,174500,Solidly Republican/Conservative,2020
Blue Wave Project,Jeff Merkley (D-Ore),162500,162500,0,Solidly Democrat/Liberal,2020
Together Fund PAC,ex-Gov. Deval Patrick (D-Mass),169700,169700,0,Solidly Democrat/Liberal,2020
Educate & Innovate PAC,Ed Markey (D-Mass),169500,169500,0,Solidly Democrat/Liberal,2020
Denali Leadership PAC,Lisa Murkowski (R-Alaska),167274,0,167274,Solidly Republican/Conservative,2020
Hawkeye PAC,Chuck Grassley (R-Iowa),166200,0,166200,Solidly Republican/Conservative,2020
Dirigo PAC,Susan Collins (R-Maine),165000,0,165000,Solidly Republican/Conservative,2020
Strategy PAC,Ron Johnson (R-Wis),165000,0,165000,Solidly Republican/Conservative,2020
Common Good PAC,Tom Suozzi (D-NY),163900,162900,1000,Solidly Democrat/Liberal,2020
Progressive Choices PAC,Jan Schakowsky (D-Ill),160000,160000,0,Solidly Democrat/Liberal,2020
Developing a New Generation PAC,Stephanie Murphy (D-Fla),157400,155400,2000,Solidly Democrat/Liberal,2020
Lets Get to Work PAC,Rick Scott (R-Fla),157244,0,157244,Solidly Republican/Conservative,2020
Victory by Investing Building & Empowering PAC,Tony Cardenas (D-Calif),154500,154500,0,Solidly Democrat/Liberal,2020
Three Rivers PAC,Kurt Schrader (D-Ore),155500,151500,4000,Solidly Democrat/Liberal,2020
Bridge the Gap PAC,Brad Schneider (D-Ill),155250,155250,0,Solidly Democrat/Liberal,2020
Spirit of '76 PAC,Dan Crenshaw (R-Texas),152500,0,152500,Solidly Republican/Conservative,2020
Building America's Republican Representation,Andy Barr (R-Ky),152051,0,152051,Solidly Republican/Conservative,2020
Synergy PAC,John B Larson (D-Conn),147500,146500,1000,Solidly Democrat/Liberal,2020
Thunderbolt PAC,Martha McSally (R-Ariz),148000,0,148000,Solidly Republican/Conservative,2020
Mr Southern Missourian in the House,Jason Smith (R-Mo),144500,0,144500,Solidly Republican/Conservative,2020
American Security PAC,Mike D Rogers (R-Ala),146500,0,146500,Solidly Republican/Conservative,2020
Land of Opportunity PAC,Bruce Westerman (R-Ark),144580,0,144580,Solidly Republican/Conservative,2020
A New Direction PAC,Jeanne Shaheen (D-NH),146000,146000,0,Solidly Democrat/Liberal,2020
EDPAC,Ed Perlmutter (D-Colo),145200,145200,0,Solidly Democrat/Liberal,2020
Patriots In Action,Roger Williams (R-Texas),144600,0,144600,Solidly Republican/Conservative,2020
Giddy Up PAC,Gov. John Hickenlooper (D-Colo),138144,138144,0,Solidly Democrat/Liberal,2020
New Millennium PAC,Robert Menendez (D-NJ),136500,136500,0,Solidly Democrat/Liberal,2020
Common Sense Colorado,Michael F Bennet (D-Colo),142000,142000,0,Solidly Democrat/Liberal,2020
Excelsior PAC,Tom Reed (R-NY),140000,3000,137000,Solidly Republican/Conservative,2020
Victory in November Election PAC,Mike Thompson (D-Calif),139884,139884,0,Solidly Democrat/Liberal,2020
BACON PAC,Don Bacon (R-Neb),138600,0,138600,Solidly Republican/Conservative,2020
"Jobs, Opportunities & Education PAC",ex-Rep. Joseph Crowley (D-NY),137106,137106,0,Solidly Democrat/Liberal,2020
Truth to Power,Katie Porter (D-Calif),134200,134200,0,Solidly Democrat/Liberal,2020
Believe In America PAC,Mitt Romney (R-Utah),136400,0,136400,Solidly Republican/Conservative,2020
Eureka PAC,Ken Calvert (R-Calif),134500,0,134500,Solidly Republican/Conservative,2020
Elbert Guillory's America,ex-State Sen. Elbert Guillory (R-La),132100,0,132100,Solidly Republican/Conservative,2020
Medicare for All PAC,Pramila Jayapal (D-Wash),130500,130500,0,Solidly Democrat/Liberal,2020
Jet PAC,Adam Kinzinger (R-Ill),130500,0,130500,Solidly Republican/Conservative,2020
Fund for the Majority,Dianne Feinstein (D-Calif),130000,130000,0,Solidly Democrat/Liberal,2020
Rural America Counts PAC,Rick Crawford (R-Ark),130000,0,130000,Solidly Republican/Conservative,2020
Blue Majority PAC,Mark Pocan (D-Wis),129991,129991,0,Solidly Democrat/Liberal,2020
Boots PAC,Markwayne Mullin (R-Okla),129700,0,129700,Solidly Republican/Conservative,2020
Peter Norbeck Leadership PAC,Mike Rounds (R-SD),127800,0,127800,Solidly Republican/Conservative,2020
Michigan's Future PAC,Dan Kildee (D-Mich),126700,127700,-1000,Solidly Democrat/Liberal,2020
Courage to Change,Alexandria Ocasio-Cortez (D-NY),127167,127167,0,Solidly Democrat/Liberal,2020
Badger PAC,Ron Kind (D-Wis),125000,125000,0,Solidly Democrat/Liberal,2020
Rod PAC,Rodney Davis (R-Ill),124433,0,124433,Solidly Republican/Conservative,2020
Serve America PAC,Seth Moulton (D-Mass),122132,122132,0,Solidly Democrat/Liberal,2020
American Innovation PAC,Ami Bera (D-Calif),120100,120100,0,Solidly Democrat/Liberal,2020
One Voice,Barbara Lee (D-Calif),119000,119000,0,Solidly Democrat/Liberal,2020
Project West PAC,Cory Gardner (R-Colo),120000,0,120000,Solidly Republican/Conservative,2020
Save America PAC,James E Risch (R-Idaho),120000,0,120000,Solidly Republican/Conservative,2020
DR RAUL PAC,Raul Ruiz (D-Calif),117700,117700,0,Solidly Democrat/Liberal,2020
Working Harder PAC,Josh Harder (D-Calif),115800,115800,0,Solidly Democrat/Liberal,2020
Americans for Legislating Excellence PAC,Alex Mooney (R-WVa),116750,0,116750,Solidly Republican/Conservative,2020
Buddy PAC,Buddy Carter (R-Ga),114000,0,114000,Solidly Republican/Conservative,2020
Brave PAC,David Scott (D-Ga),115000,113000,2000,Solidly Democrat/Liberal,2020
Supporting House Problem Solvers,Scott Peters (D-Calif),111200,111200,0,Solidly Democrat/Liberal,2020
Maintaining All Republicans in Office,Mario Diaz-Balart (R-Fla),110722,0,110722,Solidly Republican/Conservative,2020
Velvet Hammer PAC,Tina Smith (D-Minn),104600,104600,0,Solidly Democrat/Liberal,2020
Committee for Leadership & Progress,Nita M Lowey (D-NY),110000,110000,0,Solidly Democrat/Liberal,2020
21st Century Majority Fund,Johnny Isakson (R-GA),107500,0,107500,Solidly Republican/Conservative,2020
Country Roads PAC,Joe Manchin (D-WVa),107500,107500,0,Solidly Democrat/Liberal,2020
Golden Rule PAC,Charlie Crist (D-Fla),107400,107400,0,Solidly Democrat/Liberal,2020
Turquoise PAC,Ben R Lujan (D-NM),105500,105500,0,Solidly Democrat/Liberal,2020
Fighting for Missouri PAC,Josh Hawley (R-Mo),106200,0,106200,Solidly Republican/Conservative,2020
Star PAC,John Bergman (R-Mich),105415,0,105415,Solidly Republican/Conservative,2020
Jerry's PAC,Jerrold Nadler (D-NY),104000,104000,0,Solidly Democrat/Liberal,2020
TERRI PAC,Terri A Sewell (D-Ala),103500,103500,0,Solidly Democrat/Liberal,2020
Leadership for Enterprise & Opportunity,ex-Rep. Patrick Meehan (R-Pa),102000,22000,80000,Leans Republican/Conservative,2020
Clean PAC,Jared Huffman (D-Calif),101000,98500,2500,Solidly Democrat/Liberal,2020
Show-me PAC,Sam Graves (R-MO),99500,2000,97500,Solidly Republican/Conservative,2020
"Jobs, Economy & Budget Fund",ex-Rep. Jeb Hensarling (R-Texas),99250,0,99250,Solidly Republican/Conservative,2020
Support Taxfighters & Elect Effective Leaders PAC,Michelle Steel (R-Calif),98600,0,98600,Solidly Republican/Conservative,2020
Re-Joyce PAC,John Joyce (R-Pa),97500,0,97500,Solidly Republican/Conservative,2020
Thoroughbred PAC,ex-Rep. Ed Whitfield (R-Ky),97300,5500,91800,Solidly Republican/Conservative,2020
Serving Our Country PAC,Salud Carbajal (D-Calif),97100,97100,0,Solidly Democrat/Liberal,2020
Belief In Life & Liberty,Bill Johnson (R-Ohio),96800,0,96800,Solidly Republican/Conservative,2020
Hudson Valley PAC (Maloney),Sean Patrick Maloney (D-NY),96200,96200,0,Solidly Democrat/Liberal,2020
Seeking Justice Cmte,Doug Jones (D-Ala),96000,96000,0,Solidly Democrat/Liberal,2020
Progressive Americans for Democracy,Peter DeFazio (D-Ore),95000,95000,0,Solidly Democrat/Liberal,2020
Tenacious PAC,ex-Rep. Claudia Tenney (R-NY),94800,0,94800,Solidly Republican/Conservative,2020
Forever YOUNG PAC,State Rep. Young Kim (R-Calif),93400,0,93400,Solidly Republican/Conservative,2020
Taking the Hill PAC,ex-Rep. Patrick J. Murphy (D-Pa),92933,92933,0,Solidly Democrat/Liberal,2020
LATTA PAC,Robert E Latta (R-Ohio),92800,0,92800,Solidly Republican/Conservative,2020
Restoring Our Nation PAC,Ron Estes (R-Kan),92532,0,92532,Solidly Republican/Conservative,2020
LEGPAC,Ben Cardin (D-Md),92500,92500,0,Solidly Democrat/Liberal,2020
TRUST PAC,Fred Upton (R-Mich),91000,0,91000,Solidly Republican/Conservative,2020
Reviving American Jobs Again,Raja Krishnamoorthi (D-Ill),89675,89675,0,Solidly Democrat/Liberal,2020
Stand Tall America PAC,Mac Thornberry (R-Texas),90500,0,90500,Solidly Republican/Conservative,2020
Invest in a Strong & Secure America,ex-Rep. Darrell Issa (R-Calif),89600,0,89600,Solidly Republican/Conservative,2020
Build America PAC,Gregory W Meeks (D-NY),89500,89500,0,Solidly Democrat/Liberal,2020
People Helping People,Maxine Waters (D-Calif),88500,88500,0,Solidly Democrat/Liberal,2020
Cut the Bull PAC,Carol Miller (R-Wva),88400,0,88400,Solidly Republican/Conservative,2020
Protecting Integrity & Truth Together PAC,ex-Rep. Walter Jones (R-NC),83362,0,83362,Solidly Republican/Conservative,2020
Inland Empire Strikes PAC,Mark Takano (D-Calif),88200,88200,0,Solidly Democrat/Liberal,2020
Raptor PAC,August Pfluger (R-Texas),87800,0,87800,Solidly Republican/Conservative,2020
Betty PAC,Betty McCollum (D-Minn),86000,86000,0,Solidly Democrat/Liberal,2020
Having Unwavering Resolve & Determination,Will Hurd (R-Texas),86902,0,86902,Solidly Republican/Conservative,2020
Middle Class America PAC,Daniel Lipinski (D-Ill),86800,86800,0,Solidly Democrat/Liberal,2020
HoulaPAC,Chrissy Houlahan (D-Pa),85100,85100,0,Solidly Democrat/Liberal,2020
Promise PAC,Marcia L Fudge (D-Ohio),83300,83300,0,Solidly Democrat/Liberal,2020
Vitoria PAC,ex-Rep. David Valadao (R-Calif),84000,0,84000,Solidly Republican/Conservative,2020
Freedom Project,ex-Rep. John Boehner (R-Ohio),83350,0,83350,Solidly Republican/Conservative,2020
I Got Your Back PAC,Lisa Blunt Rochester (D-Del),82000,82000,0,Solidly Democrat/Liberal,2020
Kelly PAC,ex-Sen. Kelly Ayotte (R-NH),82500,0,82500,Solidly Republican/Conservative,2020
Great America Cmte,Vice President Mike Pence (R-),81400,0,81400,Solidly Republican/Conservative,2020
Tenn PAC,Lamar Alexander (R-Tenn),81000,0,81000,Solidly Republican/Conservative,2020
Conservative Promises PAC,Gary Palmer (R-Ala),80600,0,80600,Solidly Republican/Conservative,2020
Building & Restoring the American Dream,Brad Wenstrup (R-Ohio),78500,0,78500,Solidly Republican/Conservative,2020
Vote to Elect Republicans Now PAC,Vernon Buchanan (R-Fla),78500,0,78500,Solidly Republican/Conservative,2020
OrrinPAC,ex-Sen. Orrin G Hatch (R-Utah),78000,0,78000,Solidly Republican/Conservative,2020
Let's All Keep Electing Republicans PAC,Pete Stauber (R-Minn),77250,0,77250,Solidly Republican/Conservative,2020
Republicans In Congress Empowering America,Tom Rice (R-SC),76500,0,76500,Solidly Republican/Conservative,2020
Jersey Values PAC,Josh Gottheimer (D-NJ),76500,75500,1000,Solidly Democrat/Liberal,2020
Reasonable Independent Constructive & Effective,Kathleen Rice (D-NY),76100,76100,0,Solidly Democrat/Liberal,2020
DEB PAC,Debbie Lesko (R-Ariz),75850,0,75850,Solidly Republican/Conservative,2020
Strengthening the American Republic PAC,John Rutherford (R-Fla),75800,0,75800,Solidly Republican/Conservative,2020
Blue Senate PAC,Jeff Merkley (D-Ore),72500,72500,0,Solidly Democrat/Liberal,2020
LLEGO-PAC,Ruben Gallego (D-Ariz),74300,74300,0,Solidly Democrat/Liberal,2020
Making a Real Change,Marc Veasey (D-Texas),74300,74300,0,Solidly Democrat/Liberal,2020
Jam PAC,Lloyd Smucker (R-Pa),73020,0,73020,Solidly Republican/Conservative,2020
Silk PAC,Bill Pascrell Jr. (D-NJ),72000,72000,0,Solidly Democrat/Liberal,2020
AnniePAC,Ann Kuster (D-NH),69800,69800,0,Solidly Democrat/Liberal,2020
PETE PAC,ex-Rep. Pete Sessions (R-Texas),71600,0,71600,Solidly Republican/Conservative,2020
Build Our Movement,Pramila Jayapal (D-Wash),71500,71500,0,Solidly Democrat/Liberal,2020
Make It In America PAC,John Garamendi (D-Calif),69800,69800,0,Solidly Democrat/Liberal,2020
Common Sense Common Solutions,Kay Granger (R-Texas),70700,0,70700,Solidly Republican/Conservative,2020
Defend Our Conservative Senate PAC,Roger Marshall (R-Kan),70000,0,70000,Solidly Republican/Conservative,2020
On Wisconsin PAC,Bryan Steil (R-Wis),69795,0,69795,Solidly Republican/Conservative,2020
Make It Work,Angus King (I-Maine),68500,66500,2000,Solidly Democrat/Liberal,2020
Chesapeake PAC,Andy Harris (R-Md),67750,0,67750,Solidly Republican/Conservative,2020
Reinventing a New Direction,Rand Paul (R-Ky),67500,0,67500,Solidly Republican/Conservative,2020
Texas Red,Ronny Jackson (R-Texas),66500,0,66500,Solidly Republican/Conservative,2020
Salt City PAC,John Katko (R-NY),65800,0,65800,Solidly Republican/Conservative,2020
Victory & Nation PAC,Van Taylor (R-Texas),65550,0,65550,Solidly Republican/Conservative,2020
Valor PAC,Brian Mast (R-Fla),65311,0,65311,Solidly Republican/Conservative,2020
Article 1 PAC,John A Yarmuth (D-Ky),65200,65200,0,Solidly Democrat/Liberal,2020
Puget PAC,Rick Larsen (D-Wash),64400,64400,0,Solidly Democrat/Liberal,2020
Impact Cmte,Michael R Turner (R-Ohio),63746,0,63746,Solidly Republican/Conservative,2020
MURPHPAC,Christopher S Murphy (D-Conn),63500,63500,0,Solidly Democrat/Liberal,2020
Delivering American Values in DC,David Kustoff (R-Tenn),63500,0,63500,Solidly Republican/Conservative,2020
Buckeye PAC (Gonzalez),Anthony Gonzalez (R-Ohio),62200,0,62200,Solidly Republican/Conservative,2020
Vision for America PAC,Jackie Speier (D-Calif),60000,60000,0,Solidly Democrat/Liberal,2020
SAC PAC,Doris O Matsui (D-Calif),60500,60500,0,Solidly Democrat/Liberal,2020
Hope PAC,Joseph Neguse (D-Colo),61000,61000,0,Solidly Democrat/Liberal,2020
Valley First Leadership PAC,Jim Costa (D-Calif),59300,59300,0,Solidly Democrat/Liberal,2020
Truth Is Markets Work Fund,Tim Walberg (R-Mich),58500,0,58500,Solidly Republican/Conservative,2020
TEDPAC,Ted Deutch (D-Fla),58300,58300,0,Solidly Democrat/Liberal,2020
Govern PAC,ex-Rep. Charlie Dent (R-Pa),58250,0,58250,Solidly Republican/Conservative,2020
Freedom 21: Fighting for Freedom/21st Century,Chris Stewart (R-Utah),58000,0,58000,Solidly Republican/Conservative,2020
Building Opportunities for a Stronger Tomorrow,Mike Bost (R-Ill),57800,0,57800,Solidly Republican/Conservative,2020
Developing Our New National Agenda PAC,Donna Shalala (D-Fla),57500,57500,0,Solidly Democrat/Liberal,2020
Do Right Bayou,Garret Graves (R-La),56300,0,56300,Solidly Republican/Conservative,2020
Commonwealth PAC (Connolly),Gerry Connolly (D-Va),57000,57000,0,Solidly Democrat/Liberal,2020
Gateway to Leadership PAC,Mikie Sherrill (D-NJ),57000,57000,0,Solidly Democrat/Liberal,2020
Bringing America Together,Brian Fitzpatrick (R-Pa),56300,0,56300,Solidly Republican/Conservative,2020
Conservatives Harvesting Success PAC,Cindy Hyde-Smith (R-Miss),56100,0,56100,Solidly Republican/Conservative,2020
Martha PAC,Martha Roby (R-Ala),56100,0,56100,Solidly Republican/Conservative,2020
Pioneer PAC,ex-Rep. Patrick J Tiberi (R-Ohio),55791,0,55791,Solidly Republican/Conservative,2020
Supporting United States of America's Next Leaders,Susan Brooks (R-Ind),55700,0,55700,Solidly Republican/Conservative,2020
Texas First PAC,Henry Cuellar (D-Texas),55000,55000,0,Solidly Democrat/Liberal,2020
Blue Line PAC,Mike Quigley (D-Ill),53700,53700,0,Solidly Democrat/Liberal,2020
Roughrider PAC,Kelly Armstrong (R-ND),53500,0,53500,Solidly Republican/Conservative,2020
At the Table!,Grace Meng (D-NY),53000,53000,0,Solidly Democrat/Liberal,2020
Fightin' Ninth PAC,Morgan Griffith (R-VA),54000,0,54000,Solidly Republican/Conservative,2020
Husky PAC,Joe Courtney (D-Conn),53950,53950,0,Solidly Democrat/Liberal,2020
JIMMY PAC,Jimmy Panetta (D-Calif),53800,53800,0,Solidly Democrat/Liberal,2020
Deciding Critical Races,David Rouzer (R-NC),53600,0,53600,Solidly Republican/Conservative,2020
Peach PAC,Doug Collins (R-GA),53300,0,53300,Solidly Republican/Conservative,2020
Full House PAC,ex-Rep. Joe Heck (R-Nev),53100,0,53100,Solidly Republican/Conservative,2020
Growing Our Own Dynamic Economy Now,State Rep. Lance Gooden (R-Texas),53100,0,53100,Solidly Republican/Conservative,2020
BRETTPAC,Brett Guthrie (R-Ky),52500,0,52500,Solidly Republican/Conservative,2020
Service First PAC,Jason Crow (D-Colo),51500,51500,0,Solidly Democrat/Liberal,2020
Go PAC Go,Mike Gallagher (R-Wis),51500,0,51500,Solidly Republican/Conservative,2020
Road to Freedom PAC,ex-Rep. Ed Royce (R-Calif),51000,0,51000,Solidly Republican/Conservative,2020
Florida Freedom Cmte,ex-Sen. George Lemieux (R-Fla),50000,0,50000,Solidly Republican/Conservative,2020
Georgia PAC,Tom Graves (R-Ga),49000,0,49000,Solidly Republican/Conservative,2020
Making Business Excel PAC,Mike Enzi (R-Wyo),50000,0,50000,Solidly Republican/Conservative,2020
Get America Right Community in Action,Mike Garcia (R-Calif),49800,0,49800,Solidly Republican/Conservative,2020
Freedom & Security PAC,ex-Rep. John Kline (R-Minn),49500,0,49500,Solidly Republican/Conservative,2020
Trident PAC,ex-Rep. Scott W Taylor (R-Va),49320,0,49320,Solidly Republican/Conservative,2020
"Jobs, Energy & Our Founding Fathers PAC",Jeff Duncan (R-SC),49200,0,49200,Solidly Republican/Conservative,2020
Sunshine Organization for Tremendous Opportunities,Darren Soto (D-Fla),49000,49000,0,Solidly Democrat/Liberal,2020
WinNovember PAC,Steve Chabot (R-Ohio),48900,0,48900,Solidly Republican/Conservative,2020
Mainstream PAC,Zoe Lofgren (D-Calif),48807,48807,0,Solidly Democrat/Liberal,2020
GOLD PAC,Sanford Bishop (D-Ga),47700,47700,0,Solidly Democrat/Liberal,2020
VICKY PAC,Vicky Hartzler (R-Mo),47600,0,47600,Solidly Republican/Conservative,2020
Reaching for a Brighter America PAC,Robert B Aderholt (R-Ala),47500,0,47500,Solidly Republican/Conservative,2020
Together United for Liberty Integrity & Prosperity,John Moolenaar (R-Mich),47300,0,47300,Solidly Republican/Conservative,2020
Defending American Values Everywhere,David P Joyce (R-Ohio),46700,0,46700,Solidly Republican/Conservative,2020
Conservatives Organized to Advance Tmrw,ex-Sen. Dan Coats (R-Ind),45500,0,45500,Solidly Republican/Conservative,2020
America's First PAC,Rob Wittman (R-VA),45500,0,45500,Solidly Republican/Conservative,2020
Vaquero PAC,Filemon Vela (D-Texas),45337,43337,2000,Solidly Democrat/Liberal,2020
Building Renewal in America Now,Brian Babin (R-Texas),44700,0,44700,Solidly Republican/Conservative,2020
Moving America Forward,ex-Sen. Bill Nelson (D-Fla),44446,44446,0,Solidly Democrat/Liberal,2020
Speak Up America PAC,Joe Wilson (R-SC),44100,0,44100,Solidly Republican/Conservative,2020
Individuals Dedicated to Ethics & Science,Diana DeGette (D-Colo),43000,43000,0,Solidly Democrat/Liberal,2020
LOIS PAC,Lois J Frankel (D-Fla),44000,44000,0,Solidly Democrat/Liberal,2020
HeartDocPAC,Larry Bucshon (R-Ind),43700,0,43700,Solidly Republican/Conservative,2020
Believe in Life Liberty Yourself,Billy Long (R-Mo),43500,0,43500,Solidly Republican/Conservative,2020
John S Fund,John M Shimkus (R-Ill),43000,0,43000,Solidly Republican/Conservative,2020
Blue Nevada PAC,Steven Horsford (D-Nev),43000,43000,0,Solidly Democrat/Liberal,2020
Razor PAC,Steve Womack (R-Ark),42200,0,42200,Solidly Republican/Conservative,2020
Pioneer PAC (Rob Bishop),Rob Bishop (R-Utah),40500,0,40500,Solidly Republican/Conservative,2020
Truedem Leadership Fund,Marcy Kaptur (D-Ohio),40000,40000,0,Solidly Democrat/Liberal,2020
Sunflower Seeds PAC,Sharice Davids (D-Kan),41000,41000,0,Solidly Democrat/Liberal,2020
Warrior Diplomat PAC,Michael Waltz (R-Fla),41300,0,41300,Solidly Republican/Conservative,2020
Point PAC,Drew Ferguson (R-Ga),40600,0,40600,Solidly Republican/Conservative,2020
Blue Power,Don Norcross (D-NJ),40500,40500,0,Solidly Democrat/Liberal,2020
Nooga PAC,Chuck Fleischmann (R-Tenn),40000,0,40000,Solidly Republican/Conservative,2020
Secure PAC,Bennie G Thompson (D-Miss),40000,40000,0,Solidly Democrat/Liberal,2020
Help America's Leaders,Hal Rogers (R-Ky),40000,0,40000,Solidly Republican/Conservative,2020
Athena PAC,Kathy Castor (D-Fla),38500,38500,0,Solidly Democrat/Liberal,2020
Luchadora PAC,Nanette Barragan (D-Calif),39500,39500,0,Solidly Democrat/Liberal,2020
BYRNE PAC,Bradley Byrne (R-Ala),39000,0,39000,Solidly Republican/Conservative,2020
Lincoln PAC,ex-Rep. Mark Kirk (R-Ill),37933,0,37933,Solidly Republican/Conservative,2020
A Woman's Place PAC,Mary Gay Scanlon (D-Pa),37700,37700,0,Solidly Democrat/Liberal,2020
Defend & Uphold Our Nation Now,Neal Dunn (R-Fla),37300,0,37300,Solidly Republican/Conservative,2020
Hoosiers First PAC,ex-Sen. Joe Donnelly (D-Ind),37100,37100,0,Solidly Democrat/Liberal,2020
OC Jobs & Education,Lou Correa (D-Calif),35800,35800,0,Solidly Democrat/Liberal,2020
Bulldog PAC,Jodey Arrington (R-Texas),35800,0,35800,Solidly Republican/Conservative,2020
Securing Our Future PAC,Val Demings (D-Fla),35600,35600,0,Solidly Democrat/Liberal,2020
Repair The World PAC,Andy Levin (D-Mich),35300,35300,0,Solidly Democrat/Liberal,2020
Pinnacle PAC,ex-Rep. John Campbell (R-Calif),35000,0,35000,Solidly Republican/Conservative,2020
Making a Difference PAC,Madeleine Dean (D-Pa),35000,35000,0,Solidly Democrat/Liberal,2020
Your Ohio Republican Team,Troy Balderson (R-Ohio),34500,0,34500,Solidly Republican/Conservative,2020
New Voice PAC,Joyce Beatty (D-Ohio),34500,34500,0,Solidly Democrat/Liberal,2020
Giving Us Security PAC,Gus Bilirakis (R-Fla),34500,0,34500,Solidly Republican/Conservative,2020
GWEN PAC,Gwen Moore (D-Wis),34217,34217,0,Solidly Democrat/Liberal,2020
Keystone Fund,Mike Doyle (D-Pa),34000,34000,0,Solidly Democrat/Liberal,2020
No Nonsense PAC,Assemblywoman Nicole Malliotakis (R-NY),33600,0,33600,Solidly Republican/Conservative,2020
Stand PAC,Barry Loudermilk (R-Ga),33500,0,33500,Solidly Republican/Conservative,2020
Your Voice Counts,Mark R Meadows (R-NC),33341,0,33341,Solidly Republican/Conservative,2020
1848 PAC,Glenn S Grothman (R-Wis),33200,0,33200,Solidly Republican/Conservative,2020
Dutch PAC,Dutch Ruppersberger (D-Md),32800,32800,0,Solidly Democrat/Liberal,2020
YoPAC,ex-Rep. Kevin Yoder (R-Kan),32000,0,32000,Solidly Republican/Conservative,2020
Dogwood PAC,Donald McEachin (D-Va),30800,30800,0,Solidly Democrat/Liberal,2020
HECK PAC,Dennis Heck (D-Wash),31800,31800,0,Solidly Democrat/Liberal,2020
Battleground PAC,Mark Walker (R-NC),31500,0,31500,Solidly Republican/Conservative,2020
Honor Courage Commitment PAC,Tony Gonzales (R-Texas),31400,0,31400,Solidly Republican/Conservative,2020
CONA PAC,Mike Conaway (R-Texas),31000,0,31000,Solidly Republican/Conservative,2020
South Jersey United in Trust PAC,Jeff Van Drew (R-NJ),30900,0,30900,Solidly Republican/Conservative,2020
Be of Good Cheer PAC,Trey Hollingsworth (R-Ind),30600,0,30600,Solidly Republican/Conservative,2020
Calumet PAC,Pete Visclosky (D-Ind),30500,30500,0,Solidly Democrat/Liberal,2020
Midwest Values PAC,ex-Sen. Al Franken (D-Minn),30000,30000,0,Solidly Democrat/Liberal,2020
LA PAC,ex-Rep. Henry Waxman (D-Calif),27000,27000,0,Solidly Democrat/Liberal,2020
Together We Rise,Judy Chu (D-Calif),30000,30000,0,Solidly Democrat/Liberal,2020
RVFPAC,Guy Reschenthaler (R-Pa),29710,0,29710,Solidly Republican/Conservative,2020
Visionary PAC,Robin Kelly (D-Ill),29500,30500,-1000,Solidly Democrat/Liberal,2020
Utah First PAC,John Curtis (R-Utah),29400,0,29400,Solidly Republican/Conservative,2020
Old North State PAC,Ted Budd (R-NC),28900,0,28900,Solidly Republican/Conservative,2020
Valley PAC,Collin Peterson (D-Minn),28500,27500,1000,Solidly Democrat/Liberal,2020
Leadership Matters for America,ex-Gov. Chris Christie (R-NJ),28000,0,28000,Solidly Republican/Conservative,2020
Building American Conservatism PAC,Randy Weber (R-Texas),28000,0,28000,Solidly Republican/Conservative,2020
RWA Fund,Richard W Allen (R-Ga),27800,0,27800,Solidly Republican/Conservative,2020
Wells PAC,Austin Scott (R-GA),27500,0,27500,Solidly Republican/Conservative,2020
Victory East PAC,Greg Murphy (R-NC),27200,0,27200,Solidly Republican/Conservative,2020
Conservative American Republican Leadership PAC,Jerry Carl (R-Ala),27000,0,27000,Solidly Republican/Conservative,2020
Keeping America Rolling PAC,Mike Kelly (R-PA),27000,0,27000,Solidly Republican/Conservative,2020
New Energy In Washington House PAC,Dan Newhouse (R-Wash),27000,0,27000,Solidly Republican/Conservative,2020
New Opportunity for Real Monumental Action,Norma Torres (D-Calif),27000,27000,0,Solidly Democrat/Liberal,2020
"NorCal Water, Jobs, Liberty",Doug LaMalfa (R-Calif),26600,0,26600,Solidly Republican/Conservative,2020
Maple PAC,Peter Welch (D-VT),26500,26500,0,Solidly Democrat/Liberal,2020
Who Dat PAC,Cedric Richmond (D-La),26500,26500,0,Solidly Democrat/Liberal,2020
Patriot PAC (Palazzo),Steven Palazzo (R-Miss),26400,0,26400,Solidly Republican/Conservative,2020
Good Fund,ex-Rep. Bob Goodlatte (R-Va),26400,0,26400,Solidly Republican/Conservative,2020
Above the Best PAC,Anthony Brown (D-Md),26300,26300,0,Solidly Democrat/Liberal,2020
Sawtooth PAC,Mike Simpson (R-Idaho),26000,0,26000,Solidly Republican/Conservative,2020
Milk River PAC,Yvette D Clarke (D-NY),25800,25800,0,Solidly Democrat/Liberal,2020
CASTLEPAC,ex-Rep. Michael N Castle (R-Del),25550,0,25550,Solidly Republican/Conservative,2020
Funding Developing Leadership PAC,Frank D Lucas (R-Okla),25500,0,25500,Solidly Republican/Conservative,2020
Good Friends PAC,Suzanne Bonamici (D-Ore),25500,25500,0,Solidly Democrat/Liberal,2020
Making Americans Count PAC,Matt Cartwright (D-Pa),25500,23000,2500,Solidly Democrat/Liberal,2020
Fiscal Leadership & Knowing Economics,ex-Sen. Jeff Flake (R-Ariz),25000,0,25000,Solidly Republican/Conservative,2020
Mustang PAC,Greg Pence (R-Ind),24300,0,24300,Solidly Republican/Conservative,2020
Limitless Horizons PAC,Tom O'Halleran (D-Ariz),24100,24100,0,Solidly Democrat/Liberal,2020
Rooted in Community Leadership PAC,Rashida Tlaib (D-Mich),23800,23800,0,Solidly Democrat/Liberal,2020
Freedom Rings Every Day PAC,Fred Keller (R-Pa),23800,0,23800,Solidly Republican/Conservative,2020
I-PAC,David Loebsack (D-Iowa),23000,23000,0,Solidly Democrat/Liberal,2020
America Now,Andre Carson (D-Ind),23000,23000,0,Solidly Democrat/Liberal,2020
Dakota Prairie PAC,ex-Sen. Heidi Heitkamp (D-ND),22500,22500,0,Solidly Democrat/Liberal,2020
Goldfinch PAC,Chuck Grassley (R-Iowa),22500,0,22500,Solidly Republican/Conservative,2020
Bill PAC (Shuster),ex-Rep. Bill Shuster (R-Pa),21673,500,21173,Solidly Republican/Conservative,2020
New South Leadership PAC,G K Butterfield (D-NC),21500,21500,0,Solidly Democrat/Liberal,2020
ROSKAM PAC,ex-Rep. Peter Roskam (R-Ill),21500,0,21500,Solidly Republican/Conservative,2020
California Dream PAC,Mike Levin (D-Calif),21500,21500,0,Solidly Democrat/Liberal,2020
American Mosaic PAC,Lauren A Underwood (D-Ill),21500,21500,0,Solidly Democrat/Liberal,2020
Delivers PAC,State Sen. Randy Feenstra (R-Iowa),21400,0,21400,Solidly Republican/Conservative,2020
Wolf Pack,Emanuel Cleaver (D-Mo),21000,21000,0,Solidly Democrat/Liberal,2020
Creating A Majority Party Cmte,ex-Rep. Dave Camp (R-Mich),21000,0,21000,Solidly Republican/Conservative,2020
Together for Our Majority,ex-Rep. Tom Reynolds (R-NY),20750,1000,19750,Solidly Republican/Conservative,2020
City on a Hill PAC,Michael Cloud (R-Texas),20600,0,20600,Solidly Republican/Conservative,2020
Gen-Next GOP Leaders Fund,Carl DeMaio (R-Calif),20500,0,20500,Solidly Republican/Conservative,2020
Re-Light America PAC,ex-Rep. Keith J Rothfus (R-Pa),20500,0,20500,Solidly Republican/Conservative,2020
Inspiring Leadership Has a Name PAC,Ilhan Omar (D-Minn),20500,20500,0,Solidly Democrat/Liberal,2020
Block By Block PAC,Dwight Evans (D-Pa),20500,20500,0,Solidly Democrat/Liberal,2020
Southwest Leadership Fund,Tom Udall (D-NM),20300,20300,0,Solidly Democrat/Liberal,2020
Preserving America's Traditions,Pat Roberts (R-Kan),20000,0,20000,Solidly Republican/Conservative,2020
Leadership of Today & Tomorrow,Attorney General Xavier Becerra (D-Calif),20000,20000,0,Solidly Democrat/Liberal,2020
Hoosier PAC,ex-Rep. Dan Burton (R-Ind),20000,0,20000,Solidly Republican/Conservative,2020
Defense Dem PAC,Elaine Luria (D-Va),20000,20000,0,Solidly Democrat/Liberal,2020
Trent's Troops PAC,Trent Kelly (R-Miss),19800,0,19800,Solidly Republican/Conservative,2020
Dakota Leadership PAC,Dusty Johnson (R-SD),19750,0,19750,Solidly Republican/Conservative,2020
Upstate South Carolina PAC,William Timmons (R-SC),19750,0,19750,Solidly Republican/Conservative,2020
Common Good Fund,ex-Rep. Jim McDermott (D-Wash),19500,19500,0,Solidly Democrat/Liberal,2020
Bill PAC (Flores),Bill Flores (R-Texas),19500,0,19500,Solidly Republican/Conservative,2020
Rebuilding America's Trust PAC,Rob Woodall (R-Ga),19400,0,19400,Solidly Republican/Conservative,2020
Fierce PAC,Debra Haaland (D-NM),19000,19000,0,Solidly Democrat/Liberal,2020
Jeff PAC,ex-Rep. Jeff Denham (R-Calif),18809,0,18809,Solidly Republican/Conservative,2020
Ready to Work PAC,Sheila Jackson Lee (D-Texas),18800,18800,0,Solidly Democrat/Liberal,2020
Point Action PAC,Drew Ferguson (R-Ga),18800,0,18800,Solidly Republican/Conservative,2020
Midnight Sun,Don Young (R-Alaska),18500,0,18500,Solidly Republican/Conservative,2020
Leaders Only Unite PAC,ex-Rep. Lou Barletta (R-Pa),18399,0,18399,Solidly Republican/Conservative,2020
Building Innovative Good Government Solutions PAC,Andy Biggs (R-Ariz),18100,0,18100,Solidly Republican/Conservative,2020
For Our Republic's Traditions Fund,Jeff Fortenberry (R-Neb),17700,0,17700,Solidly Republican/Conservative,2020
Mass PAC,ex-Rep. Michael E Capuano (D-Mass),17500,17500,0,Solidly Democrat/Liberal,2020
Wolverine PAC,Debbie Dingell (D-Mich),17500,17500,0,Solidly Democrat/Liberal,2020
Prayerie PAC,Kevin Cramer (R-ND),17500,0,17500,Solidly Republican/Conservative,2020
Better Government PAC,ex-Sen. Byron Dorgan (D-ND),17000,17000,0,Solidly Democrat/Liberal,2020
Let's Get To Work Pac,Rick Scott (R-Fla),17200,0,17200,Solidly Republican/Conservative,2020
Help Elect Republicans Now,Kevin Hern (R-Okla),17000,0,17000,Solidly Republican/Conservative,2020
America 2.0 PAC,Tim Ryan (D),17000,17000,0,Solidly Democrat/Liberal,2020
Mac PAC,James P McGovern (D-Mass),17000,17000,0,Solidly Democrat/Liberal,2020
DAM MAN PAC,Tom Tiffany (R-Wis),17000,0,17000,Solidly Republican/Conservative,2020
Generation Go,Jimmy Gomez (D-Calif),16611,16611,0,Solidly Democrat/Liberal,2020
Carolyn's PAC,Carolyn B Maloney (D-NY),16500,16500,0,Solidly Democrat/Liberal,2020
Upstate Values PAC,Anthony Brindisi (D-NY),16400,16400,0,Solidly Democrat/Liberal,2020
Gforce PAC,Greg Gianforte (R-Mont),16000,0,16000,Solidly Republican/Conservative,2020
DBM PAC,David McKinley (R-WVa),16000,0,16000,Solidly Republican/Conservative,2020
Ocean State PAC,Jim Langevin (D-RI),16000,16000,0,Solidly Democrat/Liberal,2020
Bulldog Victory PAC II,ex-Rep. David Young (R-Iowa),16000,0,16000,Solidly Republican/Conservative,2020
Grange PAC,Stacey Plaskett (D-VI),16000,16000,0,Solidly Democrat/Liberal,2020
Protecting America Under Law,Paul Gosar (R-Ariz),15000,0,15000,Solidly Republican/Conservative,2020
One Generation PAC,Ken Buck (R-Colo),15000,0,15000,Solidly Republican/Conservative,2020
Fearless for the People,Kamala Harris (D),15000,15000,0,Solidly Democrat/Liberal,2020
Make Opportunity PAC,Mo Brooks (R-Ala),14800,0,14800,Solidly Republican/Conservative,2020
Putting New Hampshire First,Chris Pappas (D-NH),14800,14800,0,Solidly Democrat/Liberal,2020
Spark PAC,Abby Finkenauer (D-Iowa),14000,14000,0,Solidly Democrat/Liberal,2020
Never Surrender PAC,Mark Green (R-Tenn),13800,0,13800,Solidly Republican/Conservative,2020
Making a Sensible Shift in Elections,Thomas Massie (R-Ky),13400,0,13400,Solidly Republican/Conservative,2020
Taking an Independent Perspective Together Our Ntn,Scott Tipton (R-Colo),13400,0,13400,Solidly Republican/Conservative,2020
GatorPAC,Rob Maness (R-La),13000,0,13000,Solidly Republican/Conservative,2020
Ken PAC,Kenny Marchant (R-Texas),13000,0,13000,Solidly Republican/Conservative,2020
Defend Freedom PAC,Warren Davidson (R-Ohio),12800,0,12800,Solidly Republican/Conservative,2020
Defending America's Values Everywhere,David Schweikert (R-Ariz),12800,0,12800,Solidly Republican/Conservative,2020
Beat the Odds PAC,Susie Lee (D-Nev),12800,12800,0,Solidly Democrat/Liberal,2020
More Like America PAC,Lauren Baer (D-Fla),12500,12500,0,Solidly Democrat/Liberal,2020
Progressives Advancing United Leadership,Paul Tonko (D-NY),12200,12200,0,Solidly Democrat/Liberal,2020
Ax PAC,Sean P Duffy (R-Wis),12000,0,12000,Solidly Republican/Conservative,2020
Keeping Republican Ideas Strong Timely,Gov. Kristi Noem (R-SD),12000,0,12000,Solidly Republican/Conservative,2020
HellerHighWater PAC,ex-Sen. Dean Heller (R-Nev),12000,0,12000,Solidly Republican/Conservative,2020
Capitol Heel PAC,Alma Adams (D-NC),12000,12000,0,Solidly Democrat/Liberal,2020
Science Energy & Environment Change PAC,Jerry McNerney (D-Calif),12000,12000,0,Solidly Democrat/Liberal,2020
LILAC PAC,Joseph D Morelle (D-NY),12000,12000,0,Solidly Democrat/Liberal,2020
Proven Conservatives PAC,State Rep. Byron Donalds (R-Fla),12000,0,12000,Solidly Republican/Conservative,2020
Republicans Offer Sensible Solutions PAC,Ross Spano (R-Fla),11800,0,11800,Solidly Republican/Conservative,2020
Cincinnatus PAC,Cincinnati Mayor John Cranley (D),11800,11800,0,Solidly Democrat/Liberal,2020
KAT PAC,Kat Cammack (R-Fla),11500,0,11500,Solidly Republican/Conservative,2020
Building a National Knowledgeable Security PAC,Jim Banks (R-Ind),11000,0,11000,Solidly Republican/Conservative,2020
Immigration Reform Fund,ex-Rep. Luis V Gutierrez (D-Ill),10500,10500,0,Solidly Democrat/Liberal,2020
Building Our Base - Bob PAC,Bob Gibbs (R-Ohio),10000,0,10000,Solidly Republican/Conservative,2020
Acton PAC,ex-Rep. Lynn A Westmoreland (R-Ga),10000,0,10000,Solidly Republican/Conservative,2020
Majority In Congress PAC,ex-Rep. John L Mica (R-Fla),10000,0,10000,Solidly Republican/Conservative,2020
All In PAC,Colin Allred (D-Texas),10000,10000,0,Solidly Democrat/Liberal,2020
Let Texans Run Texas PAC,ex-Rep. John Culberson (R-Texas),9800,500,9300,Solidly Republican/Conservative,2020
CARTER PAC,John Carter (R-Texas),9500,0,9500,Solidly Republican/Conservative,2020
Livable Communities PAC,Raul M Grijalva (D-Ariz),9000,9000,0,Solidly Democrat/Liberal,2020
Searchlight Leadership Fund,ex-Sen. Harry Reid (D-Nev),9000,9000,0,Solidly Democrat/Liberal,2020
ELEPAC,Eliot L Engel (D-NY),9000,9000,0,Solidly Democrat/Liberal,2020
Democracy Summer Leadership PAC,Jamie Raskin (D-Md),9000,9000,0,Solidly Democrat/Liberal,2020
GUEST PAC,Michael Patrick Guest (R-Miss),9000,0,9000,Solidly Republican/Conservative,2020
Volunteer Issues PAC,Tim Burchett (R-Tenn),9000,0,9000,Solidly Republican/Conservative,2020
Accountability PAC,Bill Posey (R-Fla),8600,0,8600,Solidly Republican/Conservative,2020
All Power to The People PAC,Bobby L Rush (D-Ill),8500,8500,0,Solidly Democrat/Liberal,2020
Mark Ridley-Thomas for Supervisor 2016,LA County Supervisor Mark Ridley-Thomas (D),8400,8400,0,Solidly Democrat/Liberal,2020
Common Sense Democrat PAC,Stephen F Lynch (D-Mass),8300,8300,0,Solidly Democrat/Liberal,2020
Road to Victory PAC,ex-Rep. John J Duncan Jr. (R-Tenn),8250,0,8250,Solidly Republican/Conservative,2020
RedwingMCPAC,ex-Rep. Tim Murphy (R-Pa),8000,0,8000,Solidly Republican/Conservative,2020
Great American Fund,ex-Rep. Dan Boren (D-Okla),8000,6000,2000,Leans Democrat/Liberal,2020
First Capital PAC,Scott Perry (R-Pa),8000,0,8000,Solidly Republican/Conservative,2020
Doing Our Utmost For God Liberty & Security,Douglas L Lamborn (R-Colo),8000,0,8000,Solidly Republican/Conservative,2020
Getting Results by Engaging the Grassroots PAC,Greg Stanton (D-Ariz),8000,8000,0,Solidly Democrat/Liberal,2020
Science Truth & Expertise Matter PAC,Sean Casten (D-Ill),8000,8000,0,Solidly Democrat/Liberal,2020
HMS SCRAP PAC,Haley Stevens (D-Mich),7800,7800,0,Solidly Democrat/Liberal,2020
Defend America Now,ex-Rep. Dan Donovan (R-NY),7800,0,7800,Solidly Republican/Conservative,2020
Harvest PAC,ex-Rep. Allen Boyd (D-Fla),7750,6750,1000,Solidly Democrat/Liberal,2020
Taking Our Majority PAC,Tom McClintock (R-Calif),7700,0,7700,Solidly Republican/Conservative,2020
MAGADorn PAC,Jim Hagedorn (R-Minn),7600,0,7600,Solidly Republican/Conservative,2020
Progressive Voters of America,Bernie Sanders (D),7500,7500,0,Solidly Democrat/Liberal,2020
America Works State & Local PAC,Sherrod Brown (D-Ohio),7500,7500,0,Solidly Democrat/Liberal,2020
Making Investments Majority Insured PAC,ex-Rep. Mimi Walters (R-Calif),7500,0,7500,Solidly Republican/Conservative,2020
Americans for Republican Leadership,ex-Rep. Leonard Lance,7000,0,7000,Solidly Republican/Conservative,2020
Committee to Strengthen America,ex-Rep. Robert E. Andrews (D-NJ),7000,7000,0,Solidly Democrat/Liberal,2020
DIANE PAC,ex-Rep. Diane Black (R-Tenn),7000,0,7000,Solidly Republican/Conservative,2020
BajaAZ PAC,Ann Kirkpatrick (D-Ariz),7000,7000,0,Solidly Democrat/Liberal,2020
Women Excel PAC,Jennifer Wexton (D-Va),6800,6800,0,Solidly Democrat/Liberal,2020
Jobs Unite Labor & Industry in America,Julia Brownley (D-Calif),6800,6800,0,Solidly Democrat/Liberal,2020
Come & Take It PAC,Chip Roy (R-Texas),6750,0,6750,Solidly Republican/Conservative,2020
Transformative Change PAC,Jesus Garcia (D-Ill),4000,4000,0,Leans Democrat/Liberal,2020
RACPAC,ex-Rep. Ryan Costello (R-Pa),6500,0,6500,Solidly Republican/Conservative,2020
Innovate PAC,Mark Desaulnier (D-Calif),6000,6000,0,Solidly Democrat/Liberal,2020
Ponderosa PAC,Mark Amodei (R-Nev),6000,0,6000,Solidly Republican/Conservative,2020
Big Sky Values PAC,Gov. Steve Bullock (D-Mont),6000,6000,0,Solidly Democrat/Liberal,2020
TN4U PAC,Scott Desjarlais (R-Tenn),6000,0,6000,Solidly Republican/Conservative,2020
Democrats Against Waste in Govt PAC,ex-Rep. John Barrow (D-Ga),6000,6000,0,Solidly Democrat/Liberal,2020
Great Plains PAC,ex-Lt. Gov. Tracey Mann (R-Kansas),6000,0,6000,Solidly Republican/Conservative,2020
Steer PAC,Cynthia Lummis (R-Wyo),5600,0,5600,Solidly Republican/Conservative,2020
Making A Difference In Service to Our Nation PAC,David Madison Cawthorn (R-NC),5600,0,5600,Solidly Republican/Conservative,2020
Central Michigan Conservative Leadership,State Rep. James Lower (R-Mich),5600,0,5600,Solidly Republican/Conservative,2020
Guts PAC,ex-Rep. Alan Grayson (D-Fla),5600,5600,0,Solidly Democrat/Liberal,2020
SkiPAC,Ex-Rep. Jim Matheson (D-Utah),5600,5600,0,Solidly Democrat/Liberal,2020
Citizens Strengthening Our Majority in the House,Chris Smith (R-NJ),5600,0,5600,Solidly Republican/Conservative,2020
Buckeye Liberty PAC,Jim Jordan (R-Ohio),5600,0,5600,Solidly Republican/Conservative,2020
Moving America's Republicans Into Number One,Tom Marino (R-Pa),5600,0,5600,Solidly Republican/Conservative,2020
Leadership Responsibility & Action PAC,Lucille Roybal-Allard (D-Calif),5600,5600,0,Solidly Democrat/Liberal,2020
SALMON PAC,ex-Rep. Matt Salmon (R-Ariz),5500,0,5500,Solidly Republican/Conservative,2020
Fighting for South Texas,Vicente Gonzalez (D-Texas),5500,5500,0,Solidly Democrat/Liberal,2020
All America PAC,ex-Sen. Evan Bayh (D-Ind),5500,5500,0,Solidly Democrat/Liberal,2020
House Majority Fund,John Lewis (D-Ga),5000,5000,0,Solidly Democrat/Liberal,2020
New Republican Majority Fund,ex-Sen. Trent Lott (R-Miss),5000,0,5000,Solidly Republican/Conservative,2020
America Forward PAC,ex-Rep. John Conyers Jr (D-Mich),5000,5000,0,Solidly Democrat/Liberal,2020
Peace Through Strength PAC,Duncan D Hunter (R-Calif),5000,0,5000,Solidly Republican/Conservative,2020
Roll On Columbia,ex-Rep. Doc Hastings (R-Wash),5000,0,5000,Solidly Republican/Conservative,2020
Deep Blue,ex-Rep. Joe Sestak (D-Pa),5000,5000,0,Solidly Democrat/Liberal,2020
Lone Star Liberty Fund,John Lee Ratcliffe (R-Texas),5000,0,5000,Solidly Republican/Conservative,2020
Redemption PAC,Clay Higgins (R-La),5000,0,5000,Solidly Republican/Conservative,2020
Conservative Roundtable,George Holding (R-NC),5000,0,5000,Solidly Republican/Conservative,2020
We Ignite New Energy PAC,Justin Fareed (R-Calif),5000,2500,2500,On the fence,2020
Bulldog Victory PAC,ex-Rep. David Young (R-Iowa),5000,0,5000,Solidly Republican/Conservative,2020
Rob Bonta for Assembly 2018,Assemblyman Rob Bonta (D-Calif),4800,4800,0,Solidly Democrat/Liberal,2020
American Victory PAC,ex-Rep. Jason Chaffetz (R-Utah),4800,0,4800,Solidly Republican/Conservative,2020
77 PAC,Lt. Gov. Matt Pinnell (R-Okla),4800,0,4800,Solidly Republican/Conservative,2020
Community PAC,Hank Johnson (D-Ga),4550,4550,0,Solidly Democrat/Liberal,2020
Virginia Highlands Leadership Fund,ex-Rep. Rick Boucher (D-Va),4500,4500,0,Solidly Democrat/Liberal,2020
Long Leaf Pine PAC,ex-Sen. Kay R Hagan (D-NC),4436,4436,0,Solidly Democrat/Liberal,2020
Committed to Win PAC,Alcee L Hastings (D-Fla),4000,4000,0,Solidly Democrat/Liberal,2020
Takin Back America,ex-Rep. Todd Akin (R-Mo),4000,0,4000,Solidly Republican/Conservative,2020
Empowering Each Community PAC,Elijah E Cummings (D-Md),4000,4000,0,Solidly Democrat/Liberal,2020
Semper Fi PAC,Paul Cook (R-Calif),4000,0,4000,Solidly Republican/Conservative,2020
Port PAC,Alan Lowenthal (D-Calif),4000,4000,0,Solidly Democrat/Liberal,2020
Join Together PAC,Harley Rouda (D-Calif),4000,4000,0,Solidly Democrat/Liberal,2020
Virginia Victory Fund,Denver Riggleman (R-Va),4000,0,4000,Solidly Republican/Conservative,2020
Old Breed PAC,Richard McCormick (R-Ga),4000,0,4000,Solidly Republican/Conservative,2020
BFB PAC,Brendan Boyle (D-Pa),3800,3800,0,Solidly Democrat/Liberal,2020
Fund for American Exceptionalism,ex-Rep. Todd Rokita (R-Ind),3800,0,3800,Solidly Republican/Conservative,2020
Reform Government Leadership PAC,Lt Gov Carlos Lopez-Cantera (R-Fla),3500,0,3500,Solidly Republican/Conservative,2020
PEM PAC,ex-Rep. Patrick Murphy (D-Fla),3000,3000,0,Solidly Democrat/Liberal,2020
Arch Leadership PAC,ex-Rep. Russ Carnahan (D-Mo),3000,500,2500,Leans Republican/Conservative,2020
Tar Heel Prosperity PAC,Dan Bishop (R-NC),3000,0,3000,Solidly Republican/Conservative,2020
Putting People First PAC,Sylvia Garcia (D-Texas),3000,3000,0,Solidly Democrat/Liberal,2020
Republicans Offering Solutions for Everyone,John Rose (R-Tenn),3000,0,3000,Solidly Republican/Conservative,2020
Mark Ridley-Thomas for Supervisor 2016,LA County Supervisor Mark Ridley-Thomas (D),2800,2800,0,Solidly Democrat/Liberal,2020
Power of Us PAC,Ayanna Pressley (D-Mass),2800,2800,0,Solidly Democrat/Liberal,2020
DAN-PAFIRST PAC,Dan Meuser (R-Pa),2800,0,2800,Solidly Republican/Conservative,2020
Growing Georgia PAC,Kelly Loeffler (R-Ga),2800,0,2800,Solidly Republican/Conservative,2020
Joy PAC,Esther Joy King (R-Ill),2800,0,2800,Solidly Republican/Conservative,2020
United for Progress Leadership Cmte,ex-Rep. Jerry F. Costello (D-Ill),2800,2800,0,Solidly Democrat/Liberal,2020
Strengthening Virginia's Working Families PAC,Bobby Scott (D-Va),2800,2800,0,Solidly Democrat/Liberal,2020
Democratic Victory Fund,Los Angeles Mayor Eric Garcetti (D),2700,2700,0,Solidly Democrat/Liberal,2020
Cajun PAC,Attorney General Jeff Landry (R-LA),2600,0,2600,Solidly Republican/Conservative,2020
Buckeye Patriot PAC,ex-Rep. David Hobson (R-Ohio),2500,0,2500,Solidly Republican/Conservative,2020
Eagle PAC,ex-Rep. Bob Dold (R-Ill),2500,0,2500,Solidly Republican/Conservative,2020
Powered By People,ex-Rep. Beto O'Rourke (D-Texas),2312,2312,0,Solidly Democrat/Liberal,2020
Lead Your Nation Now PAC,ex-Rep. Lynn Jenkins (R-Kan),2250,0,2250,Solidly Republican/Conservative,2020
National Security Democrats PAC,ex-Rep Steve Israel (D-NY),2000,2000,0,Solidly Democrat/Liberal,2020
MI14,Brenda Lawrence (D-Mich),2000,2000,0,Solidly Democrat/Liberal,2020
T-MAC PAC,ex-Rep. Thomas MacArthur (R-NJ),2000,0,2000,Solidly Republican/Conservative,2020
Republicans Preserving Our Majority PAC,Paul Mitchell (R-Mich),2000,0,2000,Solidly Republican/Conservative,2020
Jenni Achieving Goals & Opportunities,Commissioner Jenniffer Gonzalez (3-PR),2000,0,2000,Solidly Republican/Conservative,2020
Getting Republicans Elected For Generations PAC,Greg Steube (R-Fla),2000,0,2000,Solidly Republican/Conservative,2020
RACE PAC,Steve Watkins (R-Kan),2000,0,2000,Solidly Republican/Conservative,2020
America Unlimited,Ted Yoho (R-Fla),1880,0,1880,Solidly Republican/Conservative,2020
G PAC,Mayor Greg Fischer (D-Louisville),1500,1500,0,Solidly Democrat/Liberal,2020
Democrats Time In Nevada,Dina Titus (D-Nev),1210,1210,0,Solidly Democrat/Liberal,2020
Nevada Values PAC,ex-Rep. Cresent Hardy (R-Nev),1203,0,1203,Solidly Republican/Conservative,2020
Longhorn PAC,ex-Rep. Lamar Smith (R-Texas),1188,0,1188,Solidly Republican/Conservative,2020
Building & Restoring America Together,ex-Rep. Dave Brat (R-Va),1150,0,1150,Solidly Republican/Conservative,2020
Pine Tree PAC,ex-Rep. Bruce Poliquin (R-Maine),1000,0,1000,Solidly Republican/Conservative,2020
Nova PAC,ex-Rep. Barbara Comstock (R-Va),1000,0,1000,Solidly Republican/Conservative,2020
What a Country! PAC,ex-Rep. Carlos Curbelo (R-Fla),1000,0,1000,Solidly Republican/Conservative,2020
Frontera Vision PAC,Veronica Escobar (D-Texas),1000,1000,0,Solidly Democrat/Liberal,2020
Build Our Future,Francis Rooney (R-Fla),1000,0,1000,Solidly Republican/Conservative,2020
Because Women Can,Bonnie Coleman (D-NJ),1000,1000,0,Solidly Democrat/Liberal,2020
Committee For Southwest Virginia,ex-Rep. Rick Boucher (D-Va),1000,1000,0,Solidly Democrat/Liberal,2020
GreggPAC,ex-Rep. Gregg Harper (R-Miss),1000,0,1000,Solidly Republican/Conservative,2020
Save America Stop Socialism PAC,Marjorie Greene (R-Ga),1000,0,1000,Solidly Republican/Conservative,2020
NORM PAC,ex-Rep. Norm Dicks (D-Wash),800,800,0,Solidly Democrat/Liberal,2020
Middle Ground PAC,ex-Rep. Timothy Johnson (R-Ill),500,0,500,Solidly Republican/Conservative,2020
HANDEL PAC,ex-Rep. Karen Handel (R-Ga),475,0,475,Solidly Republican/Conservative,2020
Double Eagle PAC,ex-Rep. Steve Knight (R-Calif),450,0,450,Solidly Republican/Conservative,2020
Fairness PAC,Mayor Bill de Blasio (D-NY),-487,-487,0,Solidly Democrat/Liberal,2020
Reason to Believe PAC,ex-Gov. Deval Patrick (D-Mass),-1000,-1000,0,Solidly Democrat/Liberal,2020
Opportunity First PAC,ex-San Antonio Mayor Julian Castro (D),-1000,-1000,0,Solidly Democrat/Liberal,2020
New York Jobs PAC,ex-Rep. Steve Israel (D-NY),-1000,-1000,0,Solidly Democrat/Liberal,2020
Defeat Bad Leaders 2020,ex-Rep. Carol Shea-Porter (D-NH),-1500,-1500,0,Solidly Democrat/Liberal,2020
Just Lead PAC,ex-Rep. Jason Lewis (R-Minn),-1700,0,-1700,Solidly Republican/Conservative,2020
Congressional House Republicans In Service PAC,Chris Collins (R-NY),-2000,0,-2000,Solidly Republican/Conservative,2020
Concerned Americans for Freedom & Opportunity,Adrian Smith (R-Neb),-2000,0,-2000,Solidly Republican/Conservative,2020
Effective Leadership Enhancing Communities Today,ex-Rep. Elizabeth Esty (D-Conn),-2300,-2300,0,Solidly Democrat/Liberal,2020
Climate Champions PAC,Jeff Merkley (D-Ore),0,0,0,On the fence,2020
ICE PAC,ex-Rep. Erik Paulsen (R-Minn),-3000,0,-3000,Solidly Republican/Conservative,2020
America's Future Fund PAC,ex-Rep. Jim Renacci (R-Ohio),-6500,0,-6500,Solidly Republican/Conservative,2020
