pac_name,affiliate,total,dem,repub,lean,year
Every Republican is Crucial PAC,Eric Cantor (R-Va),1810000,0,1810000,Solidly Republican/Conservative,2014
Freedom Project,John Boehner (R-Ohio),1385000,0,1385000,Solidly Republican/Conservative,2014
Majority Cmte PAC,Kevin McCarthy (R-Calif),1204073,0,1204073,Solidly Republican/Conservative,2014
AmeriPAC: The Fund for a Greater America,Steny H. Hoyer (D-Md),1074350,1074350,0,Solidly Democrat/Liberal,2014
Prosperity Action,Paul Ryan (R-Wis),885500,0,885500,Solidly Republican/Conservative,2014
Democrats Win Seats PAC,Debbie Wasserman Schultz (D-Fla),804950,804950,0,Solidly Democrat/Liberal,2014
"Jobs, Economy & Budget Fund",Jeb Hensarling (R-Texas),720403,0,720403,Solidly Republican/Conservative,2014
BRIDGE PAC,James E. Clyburn (D-SC),716500,716500,0,Solidly Democrat/Liberal,2014
PAC to the Future,Nancy Pelosi (D-Calif),563500,563500,0,Solidly Democrat/Liberal,2014
"Jobs, Opportunities & Education PAC",Joseph Crowley (D-NY),547100,547100,0,Solidly Democrat/Liberal,2014
Citizens for Prosperity in America Today,Pat Toomey (R-Pa),543917,0,543917,Solidly Republican/Conservative,2014
Pioneer PAC,Patrick J. Tiberi (R-Ohio),539618,0,539618,Solidly Republican/Conservative,2014
GOP Generation Y Fund,Aaron Schock (R-Ill),521088,0,521088,Solidly Republican/Conservative,2014
New Pioneers PAC,Greg Walden (R-Ore),499500,0,499500,Solidly Republican/Conservative,2014
Off The Sidelines,Kirsten Gillibrand (D-NY),488500,488500,0,Solidly Democrat/Liberal,2014
ROSKAM PAC,Peter Roskam (R-Ill),488278,0,488278,Solidly Republican/Conservative,2014
Rely on Your Beliefs,Roy Blunt (R-Mo),448000,0,448000,Solidly Republican/Conservative,2014
Alamo PAC,John Cornyn (R-Texas),435000,0,435000,Solidly Republican/Conservative,2014
Bluegrass Cmte,Mitch McConnell (R-Ky),422500,0,422500,Solidly Republican/Conservative,2014
Common Values PAC,John A. Barrasso (R-Wyo),422500,0,422500,Solidly Republican/Conservative,2014
New York Jobs PAC,Steve Israel (D-NY),415500,415500,0,Solidly Democrat/Liberal,2014
Shore PAC,Frank Pallone Jr (D-NJ),413000,413000,0,Solidly Democrat/Liberal,2014
CMR PAC,Cathy McMorris Rodgers (R-Wash),411997,0,411997,Solidly Republican/Conservative,2014
Defend America PAC,Richard C. Shelby (R-Ala),410000,0,410000,Solidly Republican/Conservative,2014
Continuing a Majority Party Action Cmte,Dave Camp (R-Mich),389500,0,389500,Solidly Republican/Conservative,2014
Heartland Values PAC,John Thune (R-SD),385000,0,385000,Solidly Republican/Conservative,2014
Peninsula PAC,Anna Eshoo (D-Calif),380500,380500,0,Solidly Democrat/Liberal,2014
Next Century Fund,Richard Burr (R-NC),376000,0,376000,Solidly Republican/Conservative,2014
Eye of the Tiger PAC,Steve Scalise (R-La),373475,0,373475,Solidly Republican/Conservative,2014
Leadership of Today & Tomorrow,Xavier Becerra (D-Calif),373208,373208,0,Solidly Democrat/Liberal,2014
CONA PAC,Mike Conaway (R-Texas),366348,0,366348,Solidly Republican/Conservative,2014
OrrinPAC,Orrin G. Hatch (R-Utah),364000,0,364000,Solidly Republican/Conservative,2014
Promoting Our Republican Team PAC,Rob Portman (R-Ohio),345500,0,345500,Solidly Republican/Conservative,2014
Impact (Schumer),Charles E. Schumer (D-NY),344200,344200,0,Solidly Democrat/Liberal,2014
Searchlight Leadership Fund,Harry Reid (D-Nev),333550,333550,0,Solidly Democrat/Liberal,2014
TRUST PAC,Fred Upton (R-Mich),333500,0,333500,Solidly Republican/Conservative,2014
Free State PAC,Jerry Moran (R-Kan),325715,0,325715,Solidly Republican/Conservative,2014
Victory Now PAC,Chris Van Hollen (D-Md),317000,317000,0,Solidly Democrat/Liberal,2014
PAC for a Level Playing Field,Elizabeth Warren (D-Mass),313800,313800,0,Solidly Democrat/Liberal,2014
Bill PAC (Shuster),Bill Shuster (R-Pa),308000,0,308000,Solidly Republican/Conservative,2014
Invest in a Strong & Secure America,Darrell Issa (R-Calif),305500,0,305500,Solidly Republican/Conservative,2014
HellerHighWater PAC,Dean Heller (R-Nev),296000,0,296000,Solidly Republican/Conservative,2014
Denali Leadership PAC,Lisa Murkowski (R-Alaska),295081,0,295081,Solidly Republican/Conservative,2014
Common Sense Colorado,Michael F. Bennet (D-Colo),292100,292100,0,Solidly Democrat/Liberal,2014
House Conservatives Fund,Bill Flores (R-Texas),290500,0,290500,Solidly Republican/Conservative,2014
PETE PAC,Pete Sessions (R-Texas),279860,0,279860,Solidly Republican/Conservative,2014
Prairie PAC,Dick Durbin (D-Ill),281250,281250,0,Solidly Democrat/Liberal,2014
Making America Prosperous,Kevin Brady (R-Texas),276300,0,276300,Solidly Republican/Conservative,2014
Solidarity PAC,George Miller (D-Calif),267255,267255,0,Solidly Democrat/Liberal,2014
Senate Victory Fund,Thad Cochran (R-Miss),265000,0,265000,Solidly Republican/Conservative,2014
Committee for the Preservation of Capitalism,Charles W Boustany Jr (R-La),262500,0,262500,Solidly Republican/Conservative,2014
Freedom Fund,Mike Crapo (R-Idaho),260500,0,260500,Solidly Republican/Conservative,2014
Jazz PAC,Mary L. Landrieu (D-La),260500,260500,0,Solidly Democrat/Liberal,2014
Tenn PAC,Lamar Alexander (R-Tenn),257500,0,257500,Solidly Republican/Conservative,2014
M-PAC,Patty Murray (D-Wash),240000,240000,0,Solidly Democrat/Liberal,2014
Oceans PAC,Sheldon Whitehouse (D-RI),240000,240000,0,Solidly Democrat/Liberal,2014
New PAC,Devin Nunes (R-Calif),239000,0,239000,Solidly Republican/Conservative,2014
Republican Majority Fund,Saxby Chambliss (R-Ga),237500,0,237500,Solidly Republican/Conservative,2014
GOALPAC,Sander Levin (D-Mich),236000,236000,0,Solidly Democrat/Liberal,2014
COLE PAC,Tom Cole (R-Okla),233500,0,233500,Solidly Republican/Conservative,2014
Country First PAC,John McCain (R-Ariz),229926,0,229926,Solidly Republican/Conservative,2014
Peak PAC,Mark Udall (D-Colo),227500,227500,0,Solidly Democrat/Liberal,2014
Responsibility & Freedom Work PAC,Roger Wicker (R-Miss),227000,0,227000,Solidly Republican/Conservative,2014
America Works PAC,Sherrod Brown (D-Ohio),227000,227000,0,Solidly Democrat/Liberal,2014
Fund for a Conservative Future,James M. Inhofe (R-Okla),225000,0,225000,Solidly Republican/Conservative,2014
Committee for a Livable Future,Earl Blumenauer (D-Ore),223750,223750,0,Solidly Democrat/Liberal,2014
Voice for Freedom,Tom Price (R-Ga),223000,0,223000,Solidly Republican/Conservative,2014
Lobo PAC,Martin Heinrich (D-NM),222000,222000,0,Solidly Democrat/Liberal,2014
Kelly PAC,Kelly Ayotte (R-NH),220000,0,220000,Solidly Republican/Conservative,2014
Common Ground PAC,Tim Kaine (D-VA),219200,219200,0,Solidly Democrat/Liberal,2014
Dakota Prairie PAC,Heidi Heitkamp (D-ND),217500,217500,0,Solidly Democrat/Liberal,2014
America's Leadership PAC,Deborah Ann Stabenow (D-Mich),214500,214500,0,Solidly Democrat/Liberal,2014
Lincoln PAC,Mark Kirk (R-Ill),216000,0,216000,Solidly Republican/Conservative,2014
Rock City PAC,Bob Corker (R-Tenn),215000,0,215000,Solidly Republican/Conservative,2014
Hawkeye PAC,Chuck Grassley (R-Iowa),211750,0,211750,Solidly Republican/Conservative,2014
Empire PAC,Kirsten Gillibrand (D-NY),210000,210000,0,Solidly Democrat/Liberal,2014
Synergy PAC,John B. Larson (D-Conn),205708,205708,0,Solidly Democrat/Liberal,2014
Green Mountain PAC,Patrick Leahy (D-Vt),205500,205500,0,Solidly Democrat/Liberal,2014
SarahPAC,ex-Gov. Sarah Palin (R-Alaska),205000,0,205000,Solidly Republican/Conservative,2014
21st Century Majority Fund,Johnny Isakson (R-GA),203000,0,203000,Solidly Republican/Conservative,2014
Fund for the Majority,Dianne Feinstein (D-Calif),202500,202500,0,Solidly Democrat/Liberal,2014
More Conservatives PAC,Patrick McHenry (R-NC),201468,0,201468,Solidly Republican/Conservative,2014
Holding Onto Oregon's Priorities,Ron Wyden (D-Ore),199000,199000,0,Solidly Democrat/Liberal,2014
Priority PAC,Mark Pryor (D-Ark),192500,192500,0,Solidly Democrat/Liberal,2014
Forward Together PAC,Mark Warner (D-Va),190500,190500,0,Solidly Democrat/Liberal,2014
Making Business Excel PAC,Mike Enzi (R-Wyo),188216,0,188216,Solidly Republican/Conservative,2014
Preserving America's Traditions,Pat Roberts (R-Kan),187500,0,187500,Solidly Republican/Conservative,2014
Follow the North Star Fund,Amy Klobuchar (D-Minn),184000,184000,0,Solidly Democrat/Liberal,2014
Long Leaf Pine PAC,Kay R. Hagan (D-NC),183500,183500,0,Solidly Democrat/Liberal,2014
John S Fund,John M. Shimkus (R-Ill),181000,1000,180000,Solidly Republican/Conservative,2014
Keystone America PAC,Bob Casey (D-Pa),176500,176500,0,Solidly Democrat/Liberal,2014
Jobs & Innovation Matter PAC,Jim Himes (D-Conn),175750,175750,0,Solidly Democrat/Liberal,2014
Treasure State PAC,Jon Tester (D-Mont),175500,175500,0,Solidly Democrat/Liberal,2014
To Organize a Majority PAC,Tom Harkin (D-Iowa),175000,175000,0,Solidly Democrat/Liberal,2014
Good Fund,Bob Goodlatte (R-VA),174000,0,174000,Solidly Republican/Conservative,2014
Nutmeg PAC,Richard Blumenthal (D-Conn),171500,171500,0,Solidly Democrat/Liberal,2014
Narragansett Bay PAC,Jack Reed (D-RI),167500,167500,0,Solidly Democrat/Liberal,2014
Freedom & Security PAC,John Kline (R-Minn),166250,0,166250,Solidly Republican/Conservative,2014
Midwest Values PAC,Al Franken (D-Minn),165100,165100,0,Solidly Democrat/Liberal,2014
Hoosiers First PAC,Joe Donnelly (D-Ind),161749,161749,0,Solidly Democrat/Liberal,2014
Conservatives Organized to Advance Tmrw,Dan Coats (R-Ind),157500,0,157500,Solidly Republican/Conservative,2014
Blue Hen PAC,Chris Coons (D-Del),157000,157000,0,Solidly Democrat/Liberal,2014
Strategy PAC,Ron Johnson (R-Wis),155000,0,155000,Solidly Republican/Conservative,2014
Fund for America's Future,Lindsey Graham (R-SC),155000,0,155000,Solidly Republican/Conservative,2014
First State PAC,Tom Carper (D-Del),154500,154500,0,Solidly Democrat/Liberal,2014
Moving America Forward,Bill Nelson (D-Fla),154500,154500,0,Solidly Democrat/Liberal,2014
People's Voice PAC,Tammy Baldwin (D-Wis),150500,150500,0,Solidly Democrat/Liberal,2014
ICE PAC,Erik Paulsen (R-Minn),150500,2000,148500,Solidly Republican/Conservative,2014
Lead Your Nation Now PAC,Lynn Jenkins (R-Kan),148000,0,148000,Solidly Republican/Conservative,2014
Huck PAC,ex-Gov. Mike Huckabee (R-),146000,0,146000,Solidly Republican/Conservative,2014
A New Direction PAC,Jeanne Shaheen (D-NH),146000,146000,0,Solidly Democrat/Liberal,2014
Great Land PAC,Mark Begich (D-Alaska),144500,144500,0,Solidly Democrat/Liberal,2014
Help America's Leaders,Hal Rogers (R-Ky),144000,0,144000,Solidly Republican/Conservative,2014
Victory in November Election PAC,Mike Thompson (D-Calif),142404,142404,0,Solidly Democrat/Liberal,2014
TACPAC,Tom Coburn (R-Okla),140500,0,140500,Solidly Republican/Conservative,2014
Liberty Project,Randy Neugebauer (R-Texas),139046,1000,138046,Solidly Republican/Conservative,2014
New Millennium PAC,Robert Menendez (D-NJ),139000,139000,0,Solidly Democrat/Liberal,2014
SCOTT PAC,Scott Garrett (R-NJ),134468,0,134468,Solidly Republican/Conservative,2014
Southwest Leadership Fund,Tom Udall (D-NM),131500,131500,0,Solidly Democrat/Liberal,2014
LEGPAC,Ben Cardin (D-Md),131000,131000,0,Solidly Democrat/Liberal,2014
MURPHPAC,Christopher S Murphy (D-Conn),130500,130500,0,Solidly Democrat/Liberal,2014
Dirigo PAC,Susan Collins (R-Maine),130000,0,130000,Solidly Republican/Conservative,2014
"Jobs, Growth & Freedom Fund",Ted Cruz (R-Texas),129775,0,129775,Solidly Republican/Conservative,2014
PAC for a Change,Barbara Boxer (D-Calif),129500,129500,0,Solidly Democrat/Liberal,2014
Badger PAC,Ron Kind (D-Wis),127363,127363,0,Solidly Democrat/Liberal,2014
Ann PAC,Ann L. Wagner (R-Mo),125025,0,125025,Solidly Republican/Conservative,2014
Glacier PAC,ex-Sen. Max Baucus (D-Mont),123500,123500,0,Solidly Democrat/Liberal,2014
Progressive Choices PAC,Jan Schakowsky (D-Ill),122250,122250,0,Solidly Democrat/Liberal,2014
LOIS PAC,Lois J Frankel (D-Fla),122209,122209,0,Solidly Democrat/Liberal,2014
Support to Ensure Victory Everywhere PAC,Steve Stivers (R-Ohio),120500,0,120500,Solidly Republican/Conservative,2014
Tallatchee Creek Inc,Jeff Sessions (R-Ala),121000,0,121000,Solidly Republican/Conservative,2014
Opportunity & Renewal PAC,Jeff Merkley (D-Ore),121000,121000,0,Solidly Democrat/Liberal,2014
Stand Tall America PAC,Mac Thornberry (R-Texas),120357,0,120357,Solidly Republican/Conservative,2014
4MA Pac,Joe Kennedy III (D-Mass),119500,119500,0,Solidly Democrat/Liberal,2014
Missourians for Accountability & Change,Claire McCaskill (D-Mo),119000,119000,0,Solidly Democrat/Liberal,2014
Democrats Against Waste in Govt PAC,John Barrow (D-Ga),118800,118800,0,Solidly Democrat/Liberal,2014
Acton PAC,Lynn A. Westmoreland (R-Ga),117500,0,117500,Solidly Republican/Conservative,2014
Country Roads PAC,Joe Manchin (D-WVa),115500,115500,0,Solidly Democrat/Liberal,2014
CoryPAC,Cory Booker (D-NJ),114500,114500,0,Solidly Democrat/Liberal,2014
Road to Freedom PAC,Ed Royce (R-Calif),113500,0,113500,Solidly Republican/Conservative,2014
Arkansas for Leadership,John Boozman (R-Ark),113500,0,113500,Solidly Republican/Conservative,2014
Eureka PAC,Ken Calvert (R-Calif),112500,0,112500,Solidly Republican/Conservative,2014
Jeff PAC,Jeff Denham (R-Calif),112023,0,112023,Solidly Republican/Conservative,2014
Allen West Guardian Fund,ex-Rep. Allen West (R-Fla),112000,0,112000,Solidly Republican/Conservative,2014
Progressive Voters of America,Bernie Sanders (I-Vt),109500,109500,0,Solidly Democrat/Liberal,2014
O'Say Can You See PAC,Gov. Martin O'Malley (D-MD),109137,109137,0,Solidly Democrat/Liberal,2014
Patriots In Action,Roger Williams (R-TX),106500,0,106500,Solidly Republican/Conservative,2014
Building A Majority PAC,Barbara A. Mikulski (D-Md),105000,105000,0,Solidly Democrat/Liberal,2014
Tomorrow Is Meaningful,Tim Scott (R-SC),102500,0,102500,Solidly Republican/Conservative,2014
Senate Majority Fund,ex-Sen. Jon L. Kyl (R-Ariz),102200,0,102200,Solidly Republican/Conservative,2014
Dutch PAC,Dutch Ruppersberger (D-Md),99500,99500,0,Solidly Democrat/Liberal,2014
Bringing Leadership Back PAC,Bruce Braley (D-Iowa),98000,98000,0,Solidly Democrat/Liberal,2014
Dakota PAC,John Hoeven (R-ND),94500,0,94500,Solidly Republican/Conservative,2014
19th Star PAC,ex-Sen. Richard G. Lugar (R-Ind),94000,5000,89000,Solidly Republican/Conservative,2014
EDPAC,Edwin G Perlmutter (D-Colo),91500,91500,0,Solidly Democrat/Liberal,2014
Del PAC,John Carney (D-Del),91200,91200,0,Solidly Democrat/Liberal,2014
Fiscal Leadership & Knowing Economics,Jeff Flake (R-Ariz),87553,0,87553,Solidly Republican/Conservative,2014
Mr Southern Missourian in the House,Jason Smith (R-Mo),86800,0,86800,Solidly Republican/Conservative,2014
South Dakota First PAC,Tim Johnson (D-SD),86000,86000,0,Solidly Democrat/Liberal,2014
Project West PAC,Cory Gardner (R-Colo),84577,0,84577,Solidly Republican/Conservative,2014
Fearless PAC,Jared Polis (D-Colo),82400,82400,0,Solidly Democrat/Liberal,2014
American Defense & Military PAC,Adam Smith (D-Wash),80950,80950,0,Solidly Democrat/Liberal,2014
MARSHA PAC,Marsha Blackburn (R-Tenn),80500,0,80500,Solidly Republican/Conservative,2014
Mountaineer PAC,Jay Rockefeller (D-WVa),76000,76000,0,Solidly Democrat/Liberal,2014
21st Century PAC,"Howard P ""Buck"" McKeon (R-Calif)",74500,0,74500,Solidly Republican/Conservative,2014
Motor City PAC,Gary Peters (D-Mich),74300,74300,0,Solidly Democrat/Liberal,2014
Ohio USA PAC,ex-Sen. George V Voinovich (R-Ohio),73500,0,73500,Solidly Republican/Conservative,2014
Rights & Responsibilities PAC,ex-Rep. Gabrielle Giffords (D-AZ),72600,54600,18000,Leans Democrat/Liberal,2014
Nebraska Sandhills PAC,Deb Fischer (R-Neb),72500,0,72500,Solidly Republican/Conservative,2014
Fund for American Opportunity,ex-Sen. Spencer Abraham (R-Mich),71266,0,71266,Solidly Republican/Conservative,2014
Greater Tomorrow PAC,Glenn Thompson (R-Pa),71000,0,71000,Solidly Republican/Conservative,2014
Gene PAC,Gene Green (D-Texas),70000,70000,0,Solidly Democrat/Liberal,2014
Pineapple PAC,Mazie K Hirono (D-Hawaii),70000,70000,0,Solidly Democrat/Liberal,2014
DIANE PAC,Diane Black (R-Tenn),68600,0,68600,Solidly Republican/Conservative,2014
Blue Majority PAC,Mark Pocan (D-Wis),67959,67959,0,Solidly Democrat/Liberal,2014
Save America PAC,James E Risch (R-Idaho),67500,0,67500,Solidly Republican/Conservative,2014
Thoroughbred PAC,Ed Whitfield (R-Ky),66954,0,66954,Solidly Republican/Conservative,2014
Keystone Fund,Mike Doyle (D-Pa),66500,66500,0,Solidly Democrat/Liberal,2014
PUCK PAC,Mike Quigley (D-Ill),66500,66500,0,Solidly Democrat/Liberal,2014
Blessings of Liberty PAC,State Sen. Mimi Walters (R-Calif),66000,0,66000,Solidly Republican/Conservative,2014
Reclaim America PAC,Marco Rubio (R-Fla),65040,0,65040,Solidly Republican/Conservative,2014
Free Markets PAC,Robert Pittenger (R-NC),65000,0,65000,Solidly Republican/Conservative,2014
Committee for Leadership & Progress,Nita M. Lowey (D-NY),65000,65000,0,Solidly Democrat/Liberal,2014
PEM PAC,Patrick E. Murphy (D-Fla),64300,64300,0,Solidly Democrat/Liberal,2014
Impact Cmte,Michael R. Turner (R-Ohio),63500,0,63500,Solidly Republican/Conservative,2014
Lone Star Leadership PAC,Michael Burgess (R-Texas),62670,0,62670,Solidly Republican/Conservative,2014
Help Unite Republicans Today PAC,Robert Hurt (R-Va),62500,0,62500,Solidly Republican/Conservative,2014
YoPAC,Kevin Yoder (R-Kan),62000,0,62000,Solidly Republican/Conservative,2014
Clean PAC,Jared Huffman (D-Calif),60500,60500,0,Solidly Democrat/Liberal,2014
New Republican Majority Fund,ex-Sen. Trent Lott (R-Miss),60500,0,60500,Solidly Republican/Conservative,2014
Leadership that Listens PAC,Donna Edwards (D-Md),60266,60266,0,Solidly Democrat/Liberal,2014
GreggPAC,Gregg Harper (R-Miss),59500,0,59500,Solidly Republican/Conservative,2014
New Vision America Fund,Mike Honda (D-Calif),59300,59300,0,Solidly Democrat/Liberal,2014
Article 1 PAC,John A. Yarmuth (D-Ky),58500,58500,0,Solidly Democrat/Liberal,2014
BRETTPAC,Brett Guthrie (R-Ky),57000,0,57000,Solidly Republican/Conservative,2014
Foxx PAC,Virginia Foxx (R-NC),56850,0,56850,Solidly Republican/Conservative,2014
Democrats Reshaping America,Linda Sanchez (D-Calif),56700,56700,0,Solidly Democrat/Liberal,2014
Educate & Innovate PAC,Ed Markey (D-Mass),56600,56600,0,Solidly Democrat/Liberal,2014
For America's Republican Majority,Tom Latham (R-Iowa),56500,0,56500,Solidly Republican/Conservative,2014
Louisiana Values PAC,John Fleming (R-La),54000,0,54000,Solidly Republican/Conservative,2014
Reinventing a New Direction,Rand Paul (R-Ky),56000,0,56000,Solidly Republican/Conservative,2014
Titletown PAC,Reid Ribble (R-Wis),55600,0,55600,Solidly Republican/Conservative,2014
Three Rivers PAC,Kurt Schrader (D-Ore),54750,54750,0,Solidly Democrat/Liberal,2014
MICHELE PAC,Michele Bachmann (R-Minn),54000,0,54000,Solidly Republican/Conservative,2014
Goh Conservative PAC/LouiePAC,Louis B Gohmert Jr (R-Texas),53500,0,53500,Solidly Republican/Conservative,2014
Puget PAC,Rick Larsen (D-Wash),52800,52800,0,Solidly Democrat/Liberal,2014
Stand up to Washington,Gov. Bobby Jindal (R-La),51529,0,51529,Solidly Republican/Conservative,2014
Conservative Victory Fund,ex-Rep. Steven D Symms (R-Idaho),48310,0,48310,Solidly Republican/Conservative,2014
Buckeye Patriot PAC,ex-Rep. David Hobson (R-Ohio),47100,0,47100,Solidly Republican/Conservative,2014
Promise Pac,Marcia L. Fudge (D-Ohio),46500,46500,0,Solidly Democrat/Liberal,2014
HECK PAC,Dennis Heck (D-Wash),46200,46200,0,Solidly Democrat/Liberal,2014
Turquoise PAC,Ben R. Lujan (D-NM),46000,46000,0,Solidly Democrat/Liberal,2014
Funding Developing Leadership PAC,Frank D. Lucas (R-Okla),45796,0,45796,Solidly Republican/Conservative,2014
Perimeter PAC,Tammy Duckworth (D-Ill),45600,45600,0,Solidly Democrat/Liberal,2014
Louisiana Reform PAC,David Vitter (R-LA),45500,0,45500,Solidly Republican/Conservative,2014
ANDER PAC,Ander Crenshaw (R-Fla),45000,0,45000,Solidly Republican/Conservative,2014
Badlands PAC,Kevin Cramer (R-ND),44700,0,44700,Solidly Republican/Conservative,2014
First Principles Fund,Ron DeSantis (R-Fla),44000,0,44000,Solidly Republican/Conservative,2014
Come Back PAC,Tim Murphy (R-Pa),43934,0,43934,Solidly Republican/Conservative,2014
Silk PAC,Bill Pascrell Jr (D-NJ),43500,43500,0,Solidly Democrat/Liberal,2014
Inland Empire Strikes PAC,Mark A Takano (D-Calif),43300,43300,0,Solidly Democrat/Liberal,2014
Majority Initiative-Keep Electing Repubs,Mike Rogers (R-Mich),43000,0,43000,Solidly Republican/Conservative,2014
Longhorn PAC,Lamar Smith (R-Texas),42300,0,42300,Solidly Republican/Conservative,2014
Progressives Advancing United Leadership,Paul Tonko (D-NY),42000,42000,0,Solidly Democrat/Liberal,2014
MI Future,Dan Kildee (D-Mich),42000,42000,0,Solidly Democrat/Liberal,2014
Marlin PAC,Marlin Stutzman (R-Ind),41000,0,41000,Solidly Republican/Conservative,2014
Big Red PAC,Lee Terry (R-Neb),40000,0,40000,Solidly Republican/Conservative,2014
Conservative Roundtable,George Holding (R-NC),39166,0,39166,Solidly Republican/Conservative,2014
Keeping Republican Ideas Strong Timely,Kristi Noem (R-SD),39157,0,39157,Solidly Republican/Conservative,2014
Excelsior PAC,Tom Reed (R-NY),39000,0,39000,Solidly Republican/Conservative,2014
Maple PAC,Peter Welch (D-VT),39000,39000,0,Solidly Democrat/Liberal,2014
Chesapeake PAC,Andy Harris (R-Md),38510,0,38510,Solidly Republican/Conservative,2014
Fund for American Exceptionalism,Todd Rokita (R-Ind),38500,0,38500,Solidly Republican/Conservative,2014
Defense Economic Renewal Education & Knowledge PAC,Derek Kilmer (D-Wash),38200,38200,0,Solidly Democrat/Liberal,2014
Wild & Wonderful PAC,Shelley Moore Capito (R-WVa),38000,0,38000,Solidly Republican/Conservative,2014
IRL PAC,Ileana Ros-Lehtinen (R-Fla),38000,0,38000,Solidly Republican/Conservative,2014
Patriots Leading a Majority,Patrick Meehan (R-Pa),37600,0,37600,Solidly Republican/Conservative,2014
Midnight Sun,Don Young (R-Alaska),37500,0,37500,Solidly Republican/Conservative,2014
Deep Blue,ex-Rep. Joe Sestak (D-Pa),36050,36050,0,Solidly Democrat/Liberal,2014
WinNovember PAC,Steve Chabot (R-Ohio),37000,0,37000,Solidly Republican/Conservative,2014
Conservatives Restoring Excellence,Renee Ellmers (R-NC),36700,0,36700,Solidly Republican/Conservative,2014
CavPAC,Mike Pompeo (R-Kan),35500,0,35500,Solidly Republican/Conservative,2014
Lank PAC,James Lankford (R-Okla),35500,0,35500,Solidly Republican/Conservative,2014
Husky PAC,Joe Courtney (D-Conn),34500,34500,0,Solidly Democrat/Liberal,2014
Ax PAC,Sean P. Duffy (R-Wis),34200,0,34200,Solidly Republican/Conservative,2014
Truth Is Markets Work Fund,Tim Walberg (R-Mich),34000,0,34000,Solidly Republican/Conservative,2014
Jerry Lewis PAC,ex-Rep. Jerry Lewis (R-Calif),34000,0,34000,Solidly Republican/Conservative,2014
Congressional House Republicans In Service PAC,Chris Collins (R-NY),33600,0,33600,Solidly Republican/Conservative,2014
Georgia PAC,Tom Graves (R-Ga),33500,0,33500,Solidly Republican/Conservative,2014
House Liberty Fund,Jim Jordan (R-Ohio),33000,0,33000,Solidly Republican/Conservative,2014
White Mountain PAC,ex-Sen. Judd Gregg (R-NH),33000,0,33000,Solidly Republican/Conservative,2014
Mainstream PAC,Zoe Lofgren (D-Calif),32500,32500,0,Solidly Democrat/Liberal,2014
GWEN PAC,Gwen Moore (D-Wis),32500,32500,0,Solidly Democrat/Liberal,2014
Southern California Fund,Brad Sherman (D-Calif),32300,32300,0,Solidly Democrat/Liberal,2014
CASTLEPAC,ex-Rep. Michael Castle (R-Del),32000,0,32000,Solidly Republican/Conservative,2014
United for A Strong America,Adam Schiff (D-Calif),32000,32000,0,Solidly Democrat/Liberal,2014
Sea Change Leadership PAC,Karen Bass (D-Calif),31744,31744,0,Solidly Democrat/Liberal,2014
Middle Class America PAC,Daniel Lipinski (D-Ill),31250,31250,0,Solidly Democrat/Liberal,2014
Betty PAC,Betty McCollum (D-Minn),31000,31000,0,Solidly Democrat/Liberal,2014
Wolverine PAC,John D. Dingell (D-Mich),31000,31000,0,Solidly Democrat/Liberal,2014
Commonwealth PAC (Connolly),Gerry Connolly (D-Va),30600,30600,0,Solidly Democrat/Liberal,2014
Wells PAC,Austin Scott (R-GA),27400,0,27400,Solidly Republican/Conservative,2014
Freedom Matters PAC,Pete Olson (R-Texas),30000,0,30000,Solidly Republican/Conservative,2014
Committee to Strengthen America,ex-Rep. Robert E. Andrews (D-NJ),30000,30000,0,Solidly Democrat/Liberal,2014
Common Good Fund,Jim McDermott (D-Wash),30000,30000,0,Solidly Democrat/Liberal,2014
Jerry's PAC,Jerrold Nadler (D-NY),30000,30000,0,Solidly Democrat/Liberal,2014
3T PAC,Nick Rahall (D-WVa),29000,29000,0,Solidly Democrat/Liberal,2014
Olympia's List,ex-Sen. Olympia Snowe (R-Maine),28500,0,28500,Solidly Republican/Conservative,2014
Making a Real Change,Marc Veasey (D-Texas),28200,28200,0,Solidly Democrat/Liberal,2014
Prairieland PAC,Mike Johanns (R-Neb),28048,0,28048,Solidly Republican/Conservative,2014
Liberty & Prosperity PAC,Rodney Frelinghuysen (R-NJ),28000,0,28000,Solidly Republican/Conservative,2014
Liberty PAC (Ron Paul),ex-Rep. Ron Paul (R-Texas),28000,0,28000,Solidly Republican/Conservative,2014
Ocean State PAC,Jim Langevin (D-RI),28000,28000,0,Solidly Democrat/Liberal,2014
Science Energy & Environment Change PAC,Jerry McNerney (D-Calif),27400,27400,0,Solidly Democrat/Liberal,2014
TERRI PAC,Terri A Sewell (D-Ala),27000,27000,0,Solidly Democrat/Liberal,2014
Congressional Majority Cmte,ex-Rep. Bill Thomas (R-Calif),27000,0,27000,Solidly Republican/Conservative,2014
Madison PAC (Neal),Richard E. Neal (D-Mass),27000,27000,0,Solidly Democrat/Liberal,2014
First In Freedom Pac,Richard Hudson (R-NC),26700,0,26700,Solidly Republican/Conservative,2014
Texas First PAC,Henry Cuellar (D-Texas),26500,26500,0,Solidly Democrat/Liberal,2014
Defending America's Future,Trent Franks (R-Ariz),25500,0,25500,Solidly Republican/Conservative,2014
DR RAUL PAC,Raul Ruiz (D-Calif),26200,26200,0,Solidly Democrat/Liberal,2014
Time to Unite Lead & Serve with Integrity,Tulsi Gabbard (D-Hawaii),26100,26100,0,Solidly Democrat/Liberal,2014
Jet PAC,Adam Kinzinger (R-Ill),25500,0,25500,Solidly Republican/Conservative,2014
Sawtooth PAC,Mike Simpson (R-Idaho),25500,0,25500,Solidly Republican/Conservative,2014
Leading Orange County PAC,Loretta Sanchez (D-CA),25400,25400,0,Solidly Democrat/Liberal,2014
Peace Through Strength Pac,Duncan D Hunter (R-Calif),25100,0,25100,Solidly Republican/Conservative,2014
Viking Leadership PAC,ex-State Rep. Tom Emmer (R-Minn),25100,0,25100,Solidly Republican/Conservative,2014
Keeping America Rolling PAC,Mike Kelly (R-PA),24500,0,24500,Solidly Republican/Conservative,2014
Big Sky Opportunity PAC,Steven Daines (R-Mont),24100,0,24100,Solidly Republican/Conservative,2014
Believe in Life Liberty Yourself,Billy Long (R-Mo),24000,0,24000,Solidly Republican/Conservative,2014
LA PAC,Henry A. Waxman (D-Calif),23000,23000,0,Solidly Democrat/Liberal,2014
Calumet PAC,Pete Visclosky (D-Ind),23000,23000,0,Solidly Democrat/Liberal,2014
Building Leadership & Inspiring New Enterprise,Blaine Luetkemeyer (R-Mo),22600,0,22600,Solidly Republican/Conservative,2014
GOLD PAC,Sanford Bishop Jr (D-Ga),22500,22500,0,Solidly Democrat/Liberal,2014
Democrats Time In Nevada,Dina Titus (D-Nev),22500,22500,0,Solidly Democrat/Liberal,2014
Buckeye Liberty PAC,Jim Jordan (R-Ohio),22000,0,22000,Solidly Republican/Conservative,2014
Full House PAC,Joe Heck (R-Nev),22000,0,22000,Solidly Republican/Conservative,2014
People Helping People,Maxine Waters (D-Calif),21500,21500,0,Solidly Democrat/Liberal,2014
Conservative Leadership Fund,Randy Forbes (R-Va),21000,0,21000,Solidly Republican/Conservative,2014
HeartDocPAC,Larry Bucshon (R-Ind),21000,0,21000,Solidly Republican/Conservative,2014
TN4U PAC,Scott Desjarlais (R-Tenn),21000,0,21000,Solidly Republican/Conservative,2014
Vision for America PAC,Jackie Speier (D-Calif),20600,20600,0,Solidly Democrat/Liberal,2014
Oorah! PAC,Todd Young (R-Ind),20500,0,20500,Solidly Republican/Conservative,2014
Supporting United States of America's Next Leaders,Susan Brooks (R-Ind),20500,0,20500,Solidly Republican/Conservative,2014
America First PAC (Miller),Gary Miller (R-Calif),20500,0,20500,Solidly Republican/Conservative,2014
DENT PAC,Charlie Dent (R-Pa),20500,0,20500,Solidly Republican/Conservative,2014
Show Me PAC,Sam Graves (R-MO),20500,0,20500,Solidly Republican/Conservative,2014
United for Progress Leadership Cmte,ex-Rep. Jerry F. Costello (D-Ill),20400,20400,0,Solidly Democrat/Liberal,2014
Bart's Bridge PAC,ex-Rep. Bart Stupak (D-Mich),20250,20250,0,Solidly Democrat/Liberal,2014
DANPAC,ex-Sen. Daniel K Inouye (D-Hawaii),20000,20000,0,Solidly Democrat/Liberal,2014
SALMON PAC,Matt Salmon (R-Ariz),20000,0,20000,Solidly Republican/Conservative,2014
Texas Republicans United PAC,Michael McCaul (R-Texas),20000,0,20000,Solidly Republican/Conservative,2014
Defending America's Values Everywhere,David Schweikert (R-Ariz),20000,0,20000,Solidly Republican/Conservative,2014
JustinPAC,Justin Amash (R-Mich),20000,0,20000,Solidly Republican/Conservative,2014
Martha PAC,Martha Roby (R-Ala),20000,0,20000,Solidly Republican/Conservative,2014
Future Leaders PAC,ex-Rep. Jerry Lewis (R-Calif),19500,0,19500,Solidly Republican/Conservative,2014
Adirondack Jobs PAC,Bill Owens (D-NY),19200,19200,0,Solidly Democrat/Liberal,2014
Strengthen America PAC,John F Tierney (D-Mass),19200,19200,0,Solidly Democrat/Liberal,2014
Make It In America PAC,John Garamendi (D-Calif),19100,19100,0,Solidly Democrat/Liberal,2014
Tipperary Hill PAC,ex-Rep. James T Walsh (R-NY),19000,0,19000,Solidly Republican/Conservative,2014
One Voice,Barbara Lee (D-Calif),19000,19000,0,Solidly Democrat/Liberal,2014
Grass Roots Initiative to Maintain Our Majority,Michael Grimm (R-NY),18600,0,18600,Solidly Republican/Conservative,2014
KITPAC 2,ex-Sen. Christopher S. 'Kit' Bond (R-MO),18053,0,18053,Solidly Republican/Conservative,2014
Hudson Valley Future Fund,ex-Rep. Nan Hayworth (R-NY),17900,0,17900,Solidly Republican/Conservative,2014
RickPAC,Gov. Rick Perry (R-TX),17900,0,17900,Solidly Republican/Conservative,2014
"Jobs, Energy & Our Founding Fathers PAC",Jeff Duncan (R-SC),17600,0,17600,Solidly Republican/Conservative,2014
SkiPAC,Jim Matheson (D-Utah),17600,17600,0,Solidly Democrat/Liberal,2014
American Liberty & Nation PAC,Alan Nunnelee (R-Miss),17500,0,17500,Solidly Republican/Conservative,2014
Semper Fi PAC,Paul Cook (R-Calif),17400,0,17400,Solidly Republican/Conservative,2014
Together PAC,Gov. Deval PatricK (D-Mass),16000,16000,0,Solidly Democrat/Liberal,2014
America's Future Fund PAC,Jim Renacci (R-Ohio),16000,0,16000,Solidly Republican/Conservative,2014
LATTA PAC,Robert E. Latta (R-Ohio),16000,0,16000,Solidly Republican/Conservative,2014
Marketplace Ideas & Conserv Knowledge,Mick Mulvaney (R-SC),16000,0,16000,Solidly Republican/Conservative,2014
DNC PAC,David Cicilline (D-RI),15000,15000,0,Solidly Democrat/Liberal,2014
Build America PAC,Gregory W. Meeks (D-NY),16000,16000,0,Solidly Democrat/Liberal,2014
Badger Fund,Tom Petri (R-Wis),15500,0,15500,Solidly Republican/Conservative,2014
Valley PAC,Collin C. Peterson (D-Minn),15500,15500,0,Solidly Democrat/Liberal,2014
Renewing the American Dream PAC,Tim Walz (D-Minn),15500,15500,0,Solidly Democrat/Liberal,2014
Virginia Leadership PAC,Jim Moran (D-VA),15160,15160,0,Solidly Democrat/Liberal,2014
13th Colony Leadership Cmte,ex-Rep. Jack Kingston (R-Ga),15000,0,15000,Solidly Republican/Conservative,2014
NORM PAC,ex-Rep. Norm Dicks (D-Wash),15000,15000,0,Solidly Democrat/Liberal,2014
Secure PAC,Bennie G. Thompson (D-Miss),15000,15000,0,Solidly Democrat/Liberal,2014
Partnership for America,Frank A. LoBiondo (R-NJ),15000,0,15000,Solidly Republican/Conservative,2014
Cool PAC,Daniel Webster (R-Fla),15000,0,15000,Solidly Republican/Conservative,2014
PITTSPAC,Joe Pitts (R-Pa),14900,0,14900,Solidly Republican/Conservative,2014
First Team PAC,Tom Rooney (R-Fla),14500,0,14500,Solidly Republican/Conservative,2014
Leadership Responsibility & Action PAC,Lucille Roybal-Allard (D-Calif),14000,14000,0,Solidly Democrat/Liberal,2014
Guts PAC,Alan Grayson (D-Fla),13900,13900,0,Solidly Democrat/Liberal,2014
Razor PAC,Steve Womack (R-Ark),13600,0,13600,Solidly Republican/Conservative,2014
Make It Work,Angus King (I-Maine),13600,11600,2000,Solidly Democrat/Liberal,2014
Growth & Prosperity PAC,Spencer Bachus (R-Ala),13600,0,13600,Solidly Republican/Conservative,2014
Texas Freedom Fund,Joe Barton (R-Texas),13500,0,13500,Solidly Republican/Conservative,2014
Patriot PAC (Palazzo),Steven Palazzo (R-Miss),13500,0,13500,Solidly Republican/Conservative,2014
Supporting House Problem Solvers,Scott Peters (D-Calif),13400,13400,0,Solidly Democrat/Liberal,2014
Fightin' Ninth PAC,Morgan Griffith (R-VA),13300,0,13300,Solidly Republican/Conservative,2014
Better Leadership - Better America,Scott Rigell (R-VA),13200,0,13200,Solidly Republican/Conservative,2014
Concerned Americans for Freedom & Opportunity,Adrian Smith (R-Neb),13000,0,13000,Solidly Republican/Conservative,2014
Love PAC,Mayor Mia Love (R-Saratoga Springs),13000,0,13000,Solidly Republican/Conservative,2014
AnniePAC,Ann McLane Kuster (D-NH),13000,13000,0,Solidly Democrat/Liberal,2014
American Security PAC,Mike D. Rogers (R-Ala),13000,0,13000,Solidly Republican/Conservative,2014
CANDICE-PAC,Candice S. Miller (R-Mich),12582,0,12582,Solidly Republican/Conservative,2014
CARTER PAC,John Carter (R-Texas),12576,0,12576,Solidly Republican/Conservative,2014
Vote to Elect Republicans Now PAC,Vernon Buchanan (R-Fla),12500,0,12500,Solidly Republican/Conservative,2014
SAC PAC,Doris O Matsui (D-Calif),12500,12500,0,Solidly Democrat/Liberal,2014
FAIRPAC,ex-Rep. John Linder (R-GA),12500,0,12500,Solidly Republican/Conservative,2014
BudgetHawks.com,Jason Chaffetz (R-Utah),12500,0,12500,Solidly Republican/Conservative,2014
GOJO PAC,ex-Rep. Jo Ann Emerson (R-Mo),12311,0,12311,Solidly Republican/Conservative,2014
Mass PAC,Michael E Capuano (D-Mass),12000,12000,0,Solidly Democrat/Liberal,2014
House Majority Fund,John Lewis (D-Ga),12000,12000,0,Solidly Democrat/Liberal,2014
Everybody Counts Everybody Matters PAC,Keith Ellison (D-Minn),12000,12000,0,Solidly Democrat/Liberal,2014
American Freedom PAC,Tim Huelskamp (R-Kan),12000,0,12000,Solidly Republican/Conservative,2014
New Voice PAC,Joyce Beatty (D-Ohio),12000,12000,0,Solidly Democrat/Liberal,2014
Lone Star Victory PAC,Pete Gallego (D-Texas),11600,11600,0,Solidly Democrat/Liberal,2014
Spending Cuts Over Total Taxation PAC,ex-Sen. Scott Brown (R-Mass),11500,0,11500,Solidly Republican/Conservative,2014
CherPAC,Cheri Bustos (D-Ill),11100,11100,0,Solidly Democrat/Liberal,2014
Brighter Futures PAC,Blake Farenthold (R-Tex),11000,0,11000,Solidly Republican/Conservative,2014
Speak Up America PAC,Joe Wilson (R-SC),11000,0,11000,Solidly Republican/Conservative,2014
Committee for a Democratic Future,Rosa L DeLauro (D-Conn),11000,11000,0,Solidly Democrat/Liberal,2014
Jobs Unite Labor & Industry in America,Julia Brownley (D-Calif),10800,10800,0,Solidly Democrat/Liberal,2014
Rebuild America PAC,Ted Yoho (R-Fla),10710,0,10710,Solidly Republican/Conservative,2014
Carolyn's PAC,Carolyn B. Maloney (D-NY),10500,10500,0,Solidly Democrat/Liberal,2014
Great American Fund,ex-Rep. Dan Boren (D-Okla),10500,4000,6500,Leans Republican/Conservative,2014
FROG Jump PAC,Steve Fincher (R-Tenn),10300,0,10300,Solidly Republican/Conservative,2014
Progressive Americans for Democracy,Peter DeFazio (D-Ore),10114,10114,0,Solidly Democrat/Liberal,2014
Motivating Energetic Leadership PAC,ex-Rep. Melvin L. Watt (D-NC),10000,10000,0,Solidly Democrat/Liberal,2014
Prairieland PAC,Michael O. Johanns (R-Neb),10000,0,10000,Solidly Republican/Conservative,2014
Victory PAC,ex-Rep. C. W. Bill Young (R-Fla),10000,0,10000,Solidly Republican/Conservative,2014
National Leadership PAC,Charles B. Rangel (D-NY),10000,10000,0,Solidly Democrat/Liberal,2014
Road to Victory PAC,John J Duncan Jr (R-Tenn),10000,0,10000,Solidly Republican/Conservative,2014
Takin Back America,ex-Rep. Todd Akin (R-Mo),10000,0,10000,Solidly Republican/Conservative,2014
Vitoria PAC,David Valadao (R-Calif),10000,0,10000,Solidly Republican/Conservative,2014
Making a Sensible Shift in Elections,Thomas Massie (R-Ky),9800,0,9800,Solidly Republican/Conservative,2014
Liberty Fund,Jaime Herrera Beutler (R-Wash),9700,0,9700,Solidly Republican/Conservative,2014
Individuals Dedicated to Ethics & Science,Diana DeGette (D-Colo),9657,9657,0,Solidly Democrat/Liberal,2014
Rangers Lead the Way,Tom Cotton (R-Ark),9600,0,9600,Solidly Republican/Conservative,2014
"Jobs, Opportunity & New Ideas PAC",State Sen. Joni Ernst (R-Iowa),9600,0,9600,Solidly Republican/Conservative,2014
Hawaii PAC,Brian Schatz (D-Hawaii),9500,9500,0,Solidly Democrat/Liberal,2014
National Org to Retain the Majority,ex-Rep. Norm Dicks (D-Wash),9500,9500,0,Solidly Democrat/Liberal,2014
Florida Delivers Leadership PAC,Corrine Brown (D-Fla),9000,9000,0,Solidly Democrat/Liberal,2014
Brave PAC,David Scott (D-Ga),8800,8800,0,Solidly Democrat/Liberal,2014
Make Opportunity PAC,Mo Brooks (R-Ala),8500,0,8500,Solidly Republican/Conservative,2014
Reaching for a Brighter America PAC,Robert B. Aderholt (R-Ala),8500,0,8500,Solidly Republican/Conservative,2014
Penguin PAC,Tim Ryan (D-Ohio),8250,8250,0,Solidly Democrat/Liberal,2014
Livable Communities PAC,Raul M Grijalva (D-Ariz),7000,7000,0,Solidly Democrat/Liberal,2014
I-PAC,David Loebsack (D-Iowa),8000,8000,0,Solidly Democrat/Liberal,2014
Americans for Republican Leadership,Leonard Lance (R-NJ),8000,0,8000,Solidly Republican/Conservative,2014
Sheriff PAC,Dave Reichert (R-Wash),8000,0,8000,Solidly Republican/Conservative,2014
America's First PAC,Rob Wittman (R-VA),8000,0,8000,Solidly Republican/Conservative,2014
Toward Tomorrow PAC,Joaquin Castro (D-Texas),8000,8000,0,Solidly Democrat/Liberal,2014
At the Table!,Grace Meng (D-NY),8000,8000,0,Solidly Democrat/Liberal,2014
Belief In Life & Liberty,Bill Johnson (R-Ohio),8000,0,8000,Solidly Republican/Conservative,2014
Mike PAC,ex-Rep. Mike Ferguson (R-NJ),7600,0,7600,Solidly Republican/Conservative,2014
Common Sense Common Solutions,Kay Granger (R-Texas),7500,0,7500,Solidly Republican/Conservative,2014
Leadership for American Opportunity,Chaka Fattah (D-Pa),7500,7500,0,Solidly Democrat/Liberal,2014
Conservative Principles PAC,Steven A. King (R-Iowa),7500,0,7500,Solidly Republican/Conservative,2014
Matt Dababneh for Assembly 2014,Assemblyman Matt Dababneh (D-Calif),7500,7500,0,Solidly Democrat/Liberal,2014
Together for Our Majority,ex-Rep. Tom Reynolds (R-NY),7250,2000,5250,Leans Republican/Conservative,2014
DOC PAC,Phil Gingrey (R-Ga),7000,0,7000,Solidly Republican/Conservative,2014
Prosper New York PAC,Richard Hanna (R-NY),7000,0,7000,Solidly Republican/Conservative,2014
Tar Heel PAC,Mike McIntyre (D-NC),7000,7000,0,Solidly Democrat/Liberal,2014
Keep Our Mission PAC,ex-Rep. Dennis Hastert (R-Ill),6800,0,6800,Solidly Republican/Conservative,2014
Giving Us Security PAC,Gus Bilirakis (R-Fla),6600,0,6600,Solidly Republican/Conservative,2014
American Innovation PAC,Ami Bera (D-Calif),6500,6500,0,Solidly Democrat/Liberal,2014
Leaders Only Unite PAC,Lou Barletta (R-Pa),6000,0,6000,Solidly Republican/Conservative,2014
Making Americans Count PAC,Matt Cartwright (D-Pa),6000,6000,0,Solidly Democrat/Liberal,2014
Secure America's Majority PAC,Sam Johnson (R-Texas),6000,0,6000,Solidly Republican/Conservative,2014
America Forward PAC,John Conyers Jr (D-Mich),6000,6000,0,Solidly Democrat/Liberal,2014
American Dream PAC,ex-Rep. Henry Bonilla (R-Texas),5500,5000,500,Solidly Democrat/Liberal,2014
America First PAC (Harrington),Karen Harrington (R-FL),5500,0,5500,Solidly Republican/Conservative,2014
Jimmy Field Campaign,Public Service Commissioner Jimmy Field (R-La),5500,0,5500,Solidly Republican/Conservative,2014
VICKY PAC,Vicky Hartzler (R-Mo),5500,0,5500,Solidly Republican/Conservative,2014
Forging the Future Fund,ex-Rep. Donald M. Payne (D-NJ),5250,5250,0,Solidly Democrat/Liberal,2014
New Energy PAC,Eric Swalwell (D-Calif),5100,5100,0,Solidly Democrat/Liberal,2014
Good Friends PAC,Suzanne Bonamici (D-Ore),5000,5000,0,Solidly Democrat/Liberal,2014
Taking an Independent Perspective Together Our Ntn,Scott Tipton (R-Colo),5000,0,5000,Solidly Republican/Conservative,2014
Immigration Reform Fund,Luis V Gutierrez (D-Ill),5000,5000,0,Solidly Democrat/Liberal,2014
Bill PAC (Flores),Bill Flores (R-Texas),5000,0,5000,Solidly Republican/Conservative,2014
Campaign for Our Country,ex-Sen. John Kerry (D-Mass),5000,5000,0,Solidly Democrat/Liberal,2014
Truedem Leadership Fund,Marcy Kaptur (D-Ohio),5000,5000,0,Solidly Democrat/Liberal,2014
Pono PAC,ex-Sen. Daniel K. Akaka (D-Hawaii),4875,4875,0,Solidly Democrat/Liberal,2014
MISSION PAC,Lois Capps (D-Calif),4500,4500,0,Solidly Democrat/Liberal,2014
We the People PAC,Allyson Schwartz (D-Pa),4500,4500,0,Solidly Democrat/Liberal,2014
Hudson Valley PAC (Maloney),Sean Patrick Maloney (D-NY),4500,4500,0,Solidly Democrat/Liberal,2014
Maintaining All Republicans in Office,Mario Diaz-Balart (R-Fla),4500,0,4500,Solidly Republican/Conservative,2014
Education & Opportunity Fund,ex-Rep. David Wu (D-Ore),4250,4250,0,Solidly Democrat/Liberal,2014
Oregon Smith Fund,ex-Rep. Bob Smith (R-Ore),4050,0,4050,Solidly Republican/Conservative,2014
Good Government for America,ex-Sen. George Allen (R-Va),4000,0,4000,Solidly Republican/Conservative,2014
Advance The Majority PAC,Jeff Miller (R-Fla),4000,0,4000,Solidly Republican/Conservative,2014
Louis D Greenwald for Assembly,Assemblyman Louis Greenwald (D-NJ),4000,4000,0,Solidly Democrat/Liberal,2014
Deeds Not Words PAC,ex-State Sen. Steven Russell (R-Okla),4000,0,4000,Solidly Republican/Conservative,2014
Athena PAC,Kathy Castor (D-Fla),4000,4000,0,Solidly Democrat/Liberal,2014
Diamond PAC,Tim Griffin (R-Ark),4000,0,4000,Solidly Republican/Conservative,2014
Keystone PAC,Jim Gerlach (R-Pa),3863,0,3863,Solidly Republican/Conservative,2014
Accountability PAC,Bill Posey (R-Fla),3600,0,3600,Solidly Republican/Conservative,2014
Louise's PAC,Louise M Slaughter (D-NY),3500,3500,0,Solidly Democrat/Liberal,2014
Building Our Base - Bob PAC,Bob Gibbs (R-Ohio),3500,0,3500,Solidly Republican/Conservative,2014
Mac PAC,James P McGovern (D-Mass),3500,3000,500,Solidly Democrat/Liberal,2014
Constitutional Conservatives Fund,Mike Lee (R-Utah),3482,0,3482,Solidly Republican/Conservative,2014
Mill to the Hill PAC,Mike Michaud (D-Maine),3250,3250,0,Solidly Democrat/Liberal,2014
Mary's PAC,ex-Rep. Mary Bono Mack (R-Calif),3015,0,3015,Solidly Republican/Conservative,2014
Leadership in the New Century,ex-Sen. Blanche Lincoln (D-Ark),3000,3000,0,Solidly Democrat/Liberal,2014
Daniel Webster PAC,ex-Sen. John E Sununu (R-NH),3000,0,3000,Solidly Republican/Conservative,2014
All America PAC,ex-Sen. Evan Bayh (D-Ind),3000,3000,0,Solidly Democrat/Liberal,2014
Lead Encourage Elect PAC,Mike Lee (R-Utah),3000,0,3000,Solidly Republican/Conservative,2014
Continuing America's Strength & Security,Bill Cassidy (R-La),3000,0,3000,Solidly Republican/Conservative,2014
America Now,Andre Carson (D-Ind),3000,3000,0,Solidly Democrat/Liberal,2014
Monadnock PAC,ex-Rep. Charles Bass (R-NH),3000,0,3000,Solidly Republican/Conservative,2014
Middle Ground PAC,ex-Rep. Timothy Johnson (R-Ill),2900,1500,1400,On the fence,2014
Aloha PAC,Gov. Neil Abercrombie (D-Hawaii),2600,2600,0,Solidly Democrat/Liberal,2014
Roll On Columbia,Doc Hastings (R-Wash),2600,0,2600,Solidly Republican/Conservative,2014
Victory by Investing Building & Empowering PAC,Tony Cardenas (D-Calif),2600,2600,0,Solidly Democrat/Liberal,2014
Freedom PAC (Hice),Jody Hice (R-Ga),2500,0,2500,Solidly Republican/Conservative,2014
California Aggressive Leadership PAC,ex-Rep. Joe Baca (D-Calif),2342,2342,0,Solidly Democrat/Liberal,2014
Progress PAC,Nydia M. Velazquez (D-NY),2000,2000,0,Solidly Democrat/Liberal,2014
Cactus PAC,Ed Pastor (D-Ariz),2000,2000,0,Solidly Democrat/Liberal,2014
Independent Action,Tom Harkin (D-Iowa),2000,2000,0,Solidly Democrat/Liberal,2014
MACK PAC,ex-Rep. Connie Mack (R-Fla),2000,0,2000,Solidly Republican/Conservative,2014
KPAC,ex-Sen. Kay Bailey Hutchison (R-Texas),2000,0,2000,Solidly Republican/Conservative,2014
Big Sky Freedom PAC,ex-Sen. Conrad Burns (R-Mont),2000,0,2000,Solidly Republican/Conservative,2014
OCPAC,John Campbell (R-Calif),2000,0,2000,Solidly Republican/Conservative,2014
Arch Leadership PAC,ex-Rep. Russ Carnahan (D-Mo),2000,1000,1000,On the fence,2014
New South Leadership PAC,G K Butterfield (D-NC),2000,2000,0,Solidly Democrat/Liberal,2014
Taxpayers Incensed By Government Excess,Dennis Ross (R-Fla),2000,0,2000,Solidly Republican/Conservative,2014
Building Infrastructure Harnessing Our Priorities,Timothy H. Bishop (D-NY),2000,2000,0,Solidly Democrat/Liberal,2014
Citizens Strengthening Our Majority in the House,Chris Smith (R-NJ),2000,0,2000,Solidly Republican/Conservative,2014
Rocket PAC,Rush Holt (D-NJ),2000,2000,0,Solidly Democrat/Liberal,2014
North Carolina Leadership Fund,Mark R. Meadows (R-NC),2000,0,2000,Solidly Republican/Conservative,2014
G PAC,Mayor Greg Fischer (D-Louisville),2000,2000,0,Solidly Democrat/Liberal,2014
Harvest PAC,ex-Rep. Allen Boyd (D-Fla),1750,1750,0,Solidly Democrat/Liberal,2014
Justice & Action/Commonwealth/Kentucky,Attorney General Jack Conway (D-KY),1625,1625,0,Solidly Democrat/Liberal,2014
Doing Our Utmost For God Liberty & Security,Douglas L. Lamborn (R-Colo),1500,0,1500,Solidly Republican/Conservative,2014
For Our Republic's Traditions Fund,Jeff Fortenberry (R-Neb),1500,0,1500,Solidly Republican/Conservative,2014
Kucinich Action PAC,ex-Rep. Dennis Kucinich (D-Ohio),0,0,0,On the fence,2014
American Sovereignty PAC,Alan L Keyes (I),1250,0,1250,Solidly Republican/Conservative,2014
ANSWER PAC,ex-Rep. John Hall (D-NY),1250,1250,0,Solidly Democrat/Liberal,2014
BOSPAC,ex-Rep. Leonard L Boswell (D-Iowa),1164,1164,0,Solidly Democrat/Liberal,2014
Serving America's Citizens PAC,ex-Rep. Dan Lungren (R-Calif),1109,0,1109,Solidly Republican/Conservative,2014
Leadership Empowerment & Development PAC,ex-Rep. Charlie A. Gonzalez (D-Texas),1000,1000,0,Solidly Democrat/Liberal,2014
Millenium Leadership PAC,Alcee L Hastings (D-Fla),1000,1000,0,Solidly Democrat/Liberal,2014
People Helping Illinois Lead PAC,ex-Rep. Phil Hare (D-Ill),1000,1000,0,Solidly Democrat/Liberal,2014
Pioneer PAC (Rob Bishop),Rob Bishop (R-Utah),1000,0,1000,Solidly Republican/Conservative,2014
Tidewater PAC,ex-Rep. Glenn Nye (D-Va),1000,1000,0,Solidly Democrat/Liberal,2014
TEX-USA Fund,ex-Rep. Chet Edwards (D-Texas),1000,1000,0,Solidly Democrat/Liberal,2014
RED PAC,ex-Rep. Adam H Putnam (R-Fla),1000,0,1000,Solidly Republican/Conservative,2014
Moderate Victory Fund,ex-Rep. Dennis Cardoza (D-Calif),1000,0,1000,Solidly Republican/Conservative,2014
Role Model Leadership PAC,Frederica Wilson (D-Fla),1000,1000,0,Solidly Democrat/Liberal,2014
Paragraph Two PAC,Luke Messer (R-Ind),1000,0,1000,Solidly Republican/Conservative,2014
American Leadership Now,Pete King (R-NY),1000,0,1000,Solidly Republican/Conservative,2014
Restoring Our American Republic,ex-Rep. J. D. Hayworth (R-Ariz),1000,0,1000,Solidly Republican/Conservative,2014
Leading Us In Success PAC,ex-Del. Luis Fortuno (R-PR),997,0,997,Solidly Republican/Conservative,2014
Solutions PAC,Dan Maffei (D-NY),500,500,0,Solidly Democrat/Liberal,2014
Big Tent PAC,ex-Sen. Arlen Specter (D-Pa),-1000,0,-1000,Solidly Republican/Conservative,2014
Committee for Southwest Virginia,ex-Rep. Rick Boucher (D-Va),-1500,-1500,0,Solidly Democrat/Liberal,2014
Majority In Congress PAC,John L Mica (R-Fla),-2000,0,-2000,Solidly Republican/Conservative,2014
