pac_name,affiliate,total,dem,repub,lean,year
AmeriPAC: The Fund for a Greater America,Steny H Hoyer (D-Md),2334546,2334546,0,Solidly Democrat/Liberal,2018
Majority Cmte PAC,Kevin McCarthy (R-Calif),2312763,0,2312763,Solidly Republican/Conservative,2018
House Freedom Fund,Mark R Meadows (R-NC),2153695,0,2153695,Solidly Republican/Conservative,2018
Prosperity Action,Paul Ryan (R-Wis),2027700,0,2027700,Solidly Republican/Conservative,2018
Eye of the Tiger PAC,Steve Scalise (R-La),1118000,0,1118000,Solidly Republican/Conservative,2018
BRIDGE PAC,James E Clyburn (D-SC),908500,908500,0,Solidly Democrat/Liberal,2018
More Conservatives PAC,Patrick McHenry (R-NC),891000,2500,888500,Solidly Republican/Conservative,2018
New Pioneers PAC,Greg Walden (R-Ore),874500,0,874500,Solidly Republican/Conservative,2018
Making America Prosperous,Kevin Brady (R-Texas),865000,0,865000,Solidly Republican/Conservative,2018
PAC to the Future,Nancy Pelosi (D-Calif),767000,767000,0,Solidly Democrat/Liberal,2018
Great America Cmte,Vice President Mike Pence (R-),742400,0,742400,Solidly Republican/Conservative,2018
"Jobs, Opportunities & Education PAC",Joseph Crowley (D-NY),711946,706946,5000,Solidly Democrat/Liberal,2018
Support to Ensure Victory Everywhere PAC,Steve Stivers (R-Ohio),678998,5000,673998,Solidly Republican/Conservative,2018
CMR PAC,Cathy McMorris Rodgers (R-Wash),618013,0,618013,Solidly Republican/Conservative,2018
United for A Strong America,Adam Schiff (D-Calif),538000,538000,0,Solidly Democrat/Liberal,2018
Off the Sidelines,Kirsten Gillibrand (D-NY),538000,538000,0,Solidly Democrat/Liberal,2018
Purpose PAC,Cory Booker (D-NJ),484000,484000,0,Solidly Democrat/Liberal,2018
Building Leadership & Inspiring New Enterprise,Blaine Luetkemeyer (R-Mo),464000,2000,462000,Solidly Republican/Conservative,2018
Turquoise PAC,Ben R Lujan (D-NM),450500,450500,0,Solidly Democrat/Liberal,2018
COLE PAC,Tom Cole (R-Okla),447700,0,447700,Solidly Republican/Conservative,2018
American Possibilities,Ex-VP Joe Biden (D),447446,447446,0,Solidly Democrat/Liberal,2018
Fearless for the People,Kamala D Harris (D-Calif),415000,415000,0,Solidly Democrat/Liberal,2018
Impact (Schumer),Charles E Schumer (D-NY),421000,421000,0,Solidly Democrat/Liberal,2018
Project West PAC,Cory Gardner (R-Colo),430000,0,430000,Solidly Republican/Conservative,2018
Fund for a Conservative Future,James M Inhofe (R-Okla),395000,0,395000,Solidly Republican/Conservative,2018
Democrats Reshaping America,Linda Sanchez (D-Calif),390736,390736,0,Solidly Democrat/Liberal,2018
Committee for a Livable Future,Earl Blumenauer (D-Ore),391500,391500,0,Solidly Democrat/Liberal,2018
Madison PAC (Neal),Richard E Neal (D-Mass),388700,388700,0,Solidly Democrat/Liberal,2018
Common Values PAC,John A Barrasso (R-Wyo),367000,0,367000,Solidly Republican/Conservative,2018
CherPAC,Cheri Bustos (D-Ill),353031,353031,0,Solidly Democrat/Liberal,2018
Alamo PAC,John Cornyn (R-Texas),345000,0,345000,Solidly Republican/Conservative,2018
One Georgia PAC,David Perdue (R-Ga),342100,0,342100,Solidly Republican/Conservative,2018
Citizens for Prosperity in America Today,Pat Toomey (R-Pa),338717,0,338717,Solidly Republican/Conservative,2018
Prairie PAC,Dick Durbin (D-Ill),332000,332000,0,Solidly Democrat/Liberal,2018
Common Ground PAC,Tim Kaine (D-Va),328500,328500,0,Solidly Democrat/Liberal,2018
Tenn PAC,Lamar Alexander (R-Tenn),330000,0,330000,Solidly Republican/Conservative,2018
Forward Together PAC,Mark Warner (D-Va),320500,320500,0,Solidly Democrat/Liberal,2018
M-PAC,Patty Murray (D-Wash),306000,306000,0,Solidly Democrat/Liberal,2018
Making Investments Majority Insured PAC,Mimi Walters (R-Calif),309800,0,309800,Solidly Republican/Conservative,2018
4MA Pac,Joe Kennedy III (D-Mass),304000,304000,0,Solidly Democrat/Liberal,2018
Keystone America PAC,Bob Casey (D-Pa),302000,302000,0,Solidly Democrat/Liberal,2018
PAC for a Level Playing Field,Elizabeth Warren (D-Mass),284441,284441,0,Solidly Democrat/Liberal,2018
Jobs & Innovation Matter PAC,Jim Himes (D-Conn),288500,288500,0,Solidly Democrat/Liberal,2018
Jeff PAC,Jeff Denham (R-Calif),287000,7500,279500,Solidly Republican/Conservative,2018
Bluegrass Cmte,Mitch McConnell (R-Ky),285000,0,285000,Solidly Republican/Conservative,2018
Jump Into Action for Conservatives To Keep Ideas,Jackie Walorski (R-Ind),283500,0,283500,Solidly Republican/Conservative,2018
Shore PAC,Frank Pallone Jr (D-NJ),280500,280500,0,Solidly Democrat/Liberal,2018
Georgia PAC,Tom Graves (R-Ga),279500,0,279500,Solidly Republican/Conservative,2018
Pioneer PAC,Patrick J Tiberi (R-Ohio),278000,0,278000,Solidly Republican/Conservative,2018
Dakota Prairie PAC,Heidi Heitkamp (D-ND),268000,268000,0,Solidly Democrat/Liberal,2018
"Jobs, Economy & Budget Fund",Jeb Hensarling (R-Texas),275500,0,275500,Solidly Republican/Conservative,2018
House Conservatives Fund,Bill Flores (R-Texas),274000,0,274000,Solidly Republican/Conservative,2018
New PAC,Devin Nunes (R-Calif),273088,0,273088,Solidly Republican/Conservative,2018
ROSKAM PAC,Peter Roskam (R-Ill),272500,0,272500,Solidly Republican/Conservative,2018
Mainstream PAC,Zoe Lofgren (D-Calif),271500,271500,0,Solidly Democrat/Liberal,2018
Common Sense Colorado,Michael F Bennet (D-Colo),267500,267500,0,Solidly Democrat/Liberal,2018
America Works PAC,Sherrod Brown (D-Ohio),251500,251500,0,Solidly Democrat/Liberal,2018
ICE PAC,Erik Paulsen (R-Minn),265900,0,265900,Solidly Republican/Conservative,2018
Making Business Excel PAC,Mike Enzi (R-Wyo),260000,0,260000,Solidly Republican/Conservative,2018
Supporting Electing American Leaders,,258200,0,258200,Solidly Republican/Conservative,2018
Great Lakes PAC,Debbie Stabenow (D-Mich),246500,246500,0,Solidly Democrat/Liberal,2018
Holding Onto Oregon's Priorities,Ron Wyden (D-Ore),246150,246150,0,Solidly Democrat/Liberal,2018
Victory & Freedom PAC,Virginia Foxx (R-NC),251000,0,251000,Solidly Republican/Conservative,2018
CONA PAC,Mike Conaway (R-Texas),250000,0,250000,Solidly Republican/Conservative,2018
Blue Momentum PAC,Ted Lieu (D-Calif),247100,247100,0,Solidly Democrat/Liberal,2018
Midwest Values PAC,Al Franken (D-Minn),237000,237000,0,Solidly Democrat/Liberal,2018
First In Freedom Pac,Richard Hudson (R-NC),246000,0,246000,Solidly Republican/Conservative,2018
All for Our Country,Catherine Cortez Masto (D-Nev),244500,244500,0,Solidly Democrat/Liberal,2018
Nutmeg PAC,Richard Blumenthal (D-Conn),234000,234000,0,Solidly Democrat/Liberal,2018
Next Century Fund,Richard Burr (R-NC),241000,0,241000,Solidly Republican/Conservative,2018
Perimeter PAC,Tammy Duckworth (D-Ill),236500,236500,0,Solidly Democrat/Liberal,2018
Treasure State PAC,Jon Tester (D-Mont),227500,227500,0,Solidly Democrat/Liberal,2018
Big Sky Opportunity PAC,Steven Daines (R-Mont),233500,0,233500,Solidly Republican/Conservative,2018
Opportunity & Renewal PAC,Jeff Merkley (D-Ore),225796,225796,0,Solidly Democrat/Liberal,2018
Promoting Our Republican Team PAC,Rob Portman (R-Ohio),231020,0,231020,Solidly Republican/Conservative,2018
Continuing America's Strength & Security,Bill Cassidy (R-La),230400,0,230400,Solidly Republican/Conservative,2018
Fund for the Majority,Dianne Feinstein (D-Calif),230000,230000,0,Solidly Democrat/Liberal,2018
Together Holding Our Majority PAC,Thom Tillis (R-NC),230000,0,230000,Solidly Republican/Conservative,2018
MARSHA PAC,Marsha Blackburn (R-Tenn),225000,0,225000,Solidly Republican/Conservative,2018
Oceans PAC,Sheldon Whitehouse (D-RI),221700,221700,0,Solidly Democrat/Liberal,2018
Follow the North Star Fund,Amy Klobuchar (D-Minn),222500,222500,0,Solidly Democrat/Liberal,2018
Moving America Forward,Bill Nelson (D-Fla),222500,222500,0,Solidly Democrat/Liberal,2018
Lank PAC,James Lankford (R-Okla),222000,0,222000,Solidly Republican/Conservative,2018
Hawkeye PAC,Chuck Grassley (R-Iowa),221000,0,221000,Solidly Republican/Conservative,2018
Hoosiers First PAC,Joe Donnelly (D-Ind),210500,210500,0,Solidly Democrat/Liberal,2018
"Jobs, Freedom & Security PAC",Ted Cruz (R-Texas),220000,0,220000,Solidly Republican/Conservative,2018
Granite Values,Maggie Hassan (D-NH),217900,217900,0,Solidly Democrat/Liberal,2018
"Jobs, Opportunity & New Ideas PAC",Joni Ernst (R-Iowa),215500,0,215500,Solidly Republican/Conservative,2018
Heartland Values PAC,John Thune (R-SD),215000,0,215000,Solidly Republican/Conservative,2018
Hawaii PAC,Brian Schatz (D-Hawaii),209350,209350,0,Solidly Democrat/Liberal,2018
Narragansett Bay PAC,Jack Reed (D-RI),206000,206000,0,Solidly Democrat/Liberal,2018
Green Mountain PAC,Patrick Leahy (D-Vt),208000,208000,0,Solidly Democrat/Liberal,2018
Wild & Wonderful PAC,Shelley Moore Capito (R-WVa),208000,0,208000,Solidly Republican/Conservative,2018
Peter Norbeck Leadership PAC,Mike Rounds (R-SD),206500,0,206500,Solidly Republican/Conservative,2018
Defend America PAC,Richard C Shelby (R-Ala),205000,0,205000,Solidly Republican/Conservative,2018
Jobs Education & Families First,Hakeem Jeffries (D-NY),204867,204867,0,Solidly Democrat/Liberal,2018
Motor City PAC,Gary Peters (D-Mich),204500,204500,0,Solidly Democrat/Liberal,2018
Electing Majority Making Effective Republicans,Tom Emmer (R-Minn),200000,0,200000,Solidly Republican/Conservative,2018
Blue Hen PAC,Chris Coons (D-Del),192500,192500,0,Solidly Democrat/Liberal,2018
Having Unwavering Resolve & Determination,Will Hurd (R-Texas),195700,0,195700,Solidly Republican/Conservative,2018
Reclaim America PAC,Marco Rubio (R-Fla),192000,0,192000,Solidly Republican/Conservative,2018
Lobo PAC,Martin Heinrich (D-NM),190250,190250,0,Solidly Democrat/Liberal,2018
In The Arena PAC,French Hill (R-Ark),186700,0,186700,Solidly Republican/Conservative,2018
Lone Star Leadership PAC,Michael Burgess (R-Texas),186500,0,186500,Solidly Republican/Conservative,2018
21st Century Majority Fund,Johnny Isakson (R-GA),185000,0,185000,Solidly Republican/Conservative,2018
Show Me PAC,Sam Graves (R-MO),183500,0,183500,Solidly Republican/Conservative,2018
MURPHPAC,Christopher S Murphy (D-Conn),180500,180500,0,Solidly Democrat/Liberal,2018
Strategy PAC,Ron Johnson (R-Wis),182500,0,182500,Solidly Republican/Conservative,2018
Bill PAC (Shuster),Bill Shuster (R-Pa),180500,2500,178000,Solidly Republican/Conservative,2018
Rely on Your Beliefs,Roy Blunt (R-Mo),177500,0,177500,Solidly Republican/Conservative,2018
Oorah! PAC,Todd Young (R-Ind),176083,0,176083,Solidly Republican/Conservative,2018
True North PAC,Dan Sullivan (R-Alaska),176000,0,176000,Solidly Republican/Conservative,2018
Ann PAC,Ann L Wagner (R-Mo),174000,0,174000,Solidly Republican/Conservative,2018
Republican Majority Fund,Tom Cotton (R-Ark),174000,0,174000,Solidly Republican/Conservative,2018
Country Roads PAC,Joe Manchin (D-WVa),172500,172500,0,Solidly Democrat/Liberal,2018
Conservative Promises PAC,Gary Palmer (R-Ala),172000,0,172000,Solidly Republican/Conservative,2018
PAC for a Change,ex-Sen. Barbara Boxer (D-Calif),169000,169000,0,Solidly Democrat/Liberal,2018
Responsibility & Freedom Work PAC,Roger Wicker (R-Miss),171000,0,171000,Solidly Republican/Conservative,2018
The US Campaign Fund,John Sarbanes (D-Md),170205,170205,0,Solidly Democrat/Liberal,2018
Serve America PAC,Seth Moulton (D-Mass),167700,167700,0,Solidly Democrat/Liberal,2018
Supporting United States of America's Next Leaders,Susan Brooks (R-Ind),166500,0,166500,Solidly Republican/Conservative,2018
BackPAC,Don Beyer (D-Va),166176,166176,0,Solidly Democrat/Liberal,2018
Freedom Fund,Mike Crapo (R-Idaho),166000,0,166000,Solidly Republican/Conservative,2018
John S Fund,John M Shimkus (R-Ill),165500,0,165500,Solidly Republican/Conservative,2018
People's Voice PAC,Tammy Baldwin (D-Wis),164500,164500,0,Solidly Democrat/Liberal,2018
Progressive Choices PAC,Jan Schakowsky (D-Ill),164887,164887,0,Solidly Democrat/Liberal,2018
Nebraska Sandhills PAC,Deb Fischer (R-Neb),164000,0,164000,Solidly Republican/Conservative,2018
Fair Shot PAC,Katherine Clark (D-Mass),161500,161500,0,Solidly Democrat/Liberal,2018
Eureka PAC,Ken Calvert (R-Calif),161000,0,161000,Solidly Republican/Conservative,2018
Defense Economic Renewal Education & Knowledge PAC,Derek Kilmer (D-Wash),160500,160500,0,Solidly Democrat/Liberal,2018
Mr Southern Missourian in the House,Jason Smith (R-Mo),159771,0,159771,Solidly Republican/Conservative,2018
Rod PAC,Rodney Davis (R-Ill),159500,0,159500,Solidly Republican/Conservative,2018
What a Country! PAC,Carlos Curbelo (R-Fla),157200,2500,154700,Solidly Republican/Conservative,2018
TRUST PAC,Fred Upton (R-Mich),157000,0,157000,Solidly Republican/Conservative,2018
Huck PAC,ex-Gov. Mike Huckabee (R-),155000,0,155000,Solidly Republican/Conservative,2018
HECK PAC,Dennis Heck (D-Wash),152700,152700,0,Solidly Democrat/Liberal,2018
Common Sense Common Solutions,Kay Granger (R-Texas),152500,0,152500,Solidly Republican/Conservative,2018
LEGPAC,Ben Cardin (D-Md),150000,150000,0,Solidly Democrat/Liberal,2018
PETE PAC,Pete Sessions (R-Texas),149200,0,149200,Solidly Republican/Conservative,2018
Building America's Republican Representation,Andy Barr (R-Ky),148000,0,148000,Solidly Republican/Conservative,2018
Missourians for Accountability & Change,Claire McCaskill (D-Mo),147000,145000,2000,Solidly Democrat/Liberal,2018
Jet PAC,Adam Kinzinger (R-Ill),146500,0,146500,Solidly Republican/Conservative,2018
DNC PAC,David Cicilline (D-RI),145180,145180,0,Solidly Democrat/Liberal,2018
First State PAC,Tom Carper (D-Del),143500,143500,0,Solidly Democrat/Liberal,2018
Dirigo PAC,Susan Collins (R-Maine),143500,0,143500,Solidly Republican/Conservative,2018
Clean PAC,Jared Huffman (D-Calif),141960,141960,0,Solidly Democrat/Liberal,2018
Abraham Lincoln PAC,Darin LaHood (R-Ill),141900,0,141900,Solidly Republican/Conservative,2018
HellerHighWater PAC,Dean Heller (R-Nev),138500,0,138500,Solidly Republican/Conservative,2018
Victory in November Election PAC,Mike Thompson (D-Calif),136985,136985,0,Solidly Democrat/Liberal,2018
YoPAC,Kevin Yoder (R-Kan),136500,0,136500,Solidly Republican/Conservative,2018
A New Direction PAC,Jeanne Shaheen (D-NH),134502,134502,0,Solidly Democrat/Liberal,2018
Lead Encourage Elect PAC,Mike Lee (R-Utah),133500,0,133500,Solidly Republican/Conservative,2018
Supporting House Problem Solvers,Scott Peters (D-Calif),131000,131000,0,Solidly Democrat/Liberal,2018
Tenacious PAC,Claudia Tenney (R-NY),131400,0,131400,Solidly Republican/Conservative,2018
Arkansas for Leadership,John Boozman (R-Ark),130000,0,130000,Solidly Republican/Conservative,2018
Committee for Leadership & Progress,Nita M Lowey (D-NY),129879,129879,0,Solidly Democrat/Liberal,2018
Ax PAC,Sean P Duffy (R-Wis),127500,0,127500,Solidly Republican/Conservative,2018
Denali Leadership PAC,Lisa Murkowski (R-Alaska),126574,0,126574,Solidly Republican/Conservative,2018
Jerry's PAC,Jerrold Nadler (D-NY),126000,126000,0,Solidly Democrat/Liberal,2018
Victory Now PAC,Chris Van Hollen (D-Md),126000,126000,0,Solidly Democrat/Liberal,2018
Three Rivers PAC,Kurt Schrader (D-Ore),125500,125500,0,Solidly Democrat/Liberal,2018
Fund for America's Future,Lindsey Graham (R-SC),124500,0,124500,Solidly Republican/Conservative,2018
Tomorrow Is Meaningful,Tim Scott (R-SC),124000,0,124000,Solidly Republican/Conservative,2018
Southwest Leadership Fund,Tom Udall (D-NM),123500,123500,0,Solidly Democrat/Liberal,2018
Texas Republicans United PAC,Michael McCaul (R-Texas),121500,0,121500,Solidly Republican/Conservative,2018
Thunderbolt PAC,Martha McSally (R-Ariz),121100,0,121100,Solidly Republican/Conservative,2018
American Security PAC,Mike D Rogers (R-Ala),120500,0,120500,Solidly Republican/Conservative,2018
Badger PAC,Ron Kind (D-Wis),120500,120500,0,Solidly Democrat/Liberal,2018
Empire PAC,Kirsten Gillibrand (D-NY),120000,120000,0,Solidly Democrat/Liberal,2018
EDPAC,Ed Perlmutter (D-Colo),119500,119500,0,Solidly Democrat/Liberal,2018
Thoroughbred PAC,ex-Rep. Ed Whitfield (R-Ky),119000,9500,109500,Solidly Republican/Conservative,2018
Democrats Win Seats PAC,Debbie Wasserman Schultz (D-Fla),118250,118250,0,Solidly Democrat/Liberal,2018
E-PAC,Elise Stefanik (R-NY),118000,0,118000,Solidly Republican/Conservative,2018
Sensible American Solutions Supporting Everyone,Ben Sasse (R-Neb),115000,0,115000,Solidly Republican/Conservative,2018
Michigan's Future PAC,Dan Kildee (D-Mich),115000,115000,0,Solidly Democrat/Liberal,2018
Speak Up America PAC,Joe Wilson (R-SC),114544,0,114544,Solidly Republican/Conservative,2018
Educate & Innovate PAC,Ed Markey (D-Mass),113500,113500,0,Solidly Democrat/Liberal,2018
New Millennium PAC,Robert Menendez (D-NJ),113094,113094,0,Solidly Democrat/Liberal,2018
Stand Tall America PAC,Mac Thornberry (R-Texas),112500,0,112500,Solidly Republican/Conservative,2018
Synergy PAC,John B Larson (D-Conn),110500,110500,0,Solidly Democrat/Liberal,2018
Getting Stuff Done PAC,Kyrsten Sinema (D-Ariz),108900,108900,0,Solidly Democrat/Liberal,2018
Do Right Bayou,Garret Graves (R-La),107700,0,107700,Solidly Republican/Conservative,2018
Pineapple PAC,Mazie K Hirono (D-Hawaii),107500,107500,0,Solidly Democrat/Liberal,2018
Lee PAC,Lee Zeldin (R-NY),106500,0,106500,Solidly Republican/Conservative,2018
Help America's Leaders,Hal Rogers (R-Ky),106500,0,106500,Solidly Republican/Conservative,2018
Good Fund,Bob Goodlatte (R-VA),106217,0,106217,Solidly Republican/Conservative,2018
DR RAUL PAC,Raul Ruiz (D-Calif),106100,106100,0,Solidly Democrat/Liberal,2018
Blue Majority PAC,Mark Pocan (D-Wis),105853,105853,0,Solidly Democrat/Liberal,2018
Democratic Midterm Victory Fund,Los Angeles Mayor Eric Garcetti (D),103500,103500,0,Solidly Democrat/Liberal,2018
Dakota PAC,John Hoeven (R-ND),102500,0,102500,Solidly Republican/Conservative,2018
Wolverine PAC,Debbie Dingell (D-Mich),99500,99500,0,Solidly Democrat/Liberal,2018
Martha PAC,Martha Roby (R-Ala),99000,0,99000,Solidly Republican/Conservative,2018
Buddy PAC,Buddy Carter (R-Ga),97900,0,97900,Solidly Republican/Conservative,2018
Excelsior PAC,Tom Reed (R-NY),97000,0,97000,Solidly Republican/Conservative,2018
CA-LUV PAC,Pete Aguilar (D-Calif),95800,95800,0,Solidly Democrat/Liberal,2018
OrrinPAC,Orrin G Hatch (R-Utah),95000,0,95000,Solidly Republican/Conservative,2018
Liberty Fund,Jaime Herrera Beutler (R-Wash),94550,0,94550,Solidly Republican/Conservative,2018
Invest in a Strong & Secure America,Darrell Issa (R-Calif),93600,0,93600,Solidly Republican/Conservative,2018
Americans for Legislating Excellence PAC,Alex Mooney (R-WVa),93300,0,93300,Solidly Republican/Conservative,2018
Preserving America's Traditions,Pat Roberts (R-Kan),93000,0,93000,Solidly Republican/Conservative,2018
Free State PAC,Jerry Moran (R-Kan),92500,0,92500,Solidly Republican/Conservative,2018
Make It Work,Angus King (I-Maine),91300,91300,0,Solidly Democrat/Liberal,2018
Greater Tomorrow PAC,Glenn Thompson (R-Pa),90500,0,90500,Solidly Republican/Conservative,2018
BRETTPAC,Brett Guthrie (R-Ky),90500,0,90500,Solidly Republican/Conservative,2018
LOIS PAC,Lois J Frankel (D-Fla),89000,89000,0,Solidly Democrat/Liberal,2018
One Voice,Barbara Lee (D-Calif),88200,88200,0,Solidly Democrat/Liberal,2018
Road to Freedom PAC,Ed Royce (R-Calif),88000,0,88000,Solidly Republican/Conservative,2018
IRL PAC,Ileana Ros-Lehtinen (R-Fla),86000,0,86000,Solidly Republican/Conservative,2018
Re-Light America PAC,Keith J Rothfus (R-Pa),86900,2000,84900,Solidly Republican/Conservative,2018
Keeping America Rolling PAC,Mike Kelly (R-PA),86500,0,86500,Solidly Republican/Conservative,2018
American Innovation PAC,Ami Bera (D-Calif),86400,85400,1000,Solidly Democrat/Liberal,2018
Securing Every American's Liberty PAC,Scott W Taylor (R-Va),85700,0,85700,Solidly Republican/Conservative,2018
Golden Rule PAC,Charlie Crist (D-Fla),83600,83600,0,Solidly Democrat/Liberal,2018
RACPAC,Ryan Costello (R-Pa),82500,0,82500,Solidly Republican/Conservative,2018
Jersey Values PAC,Josh Gottheimer (D-NJ),81500,81500,0,Solidly Democrat/Liberal,2018
Dutch PAC,Dutch Ruppersberger (D-Md),81500,81500,0,Solidly Democrat/Liberal,2018
Climate Champions PAC,Jeff Merkley (D-Ore),68500,68500,0,Solidly Democrat/Liberal,2018
Inland Empire Strikes PAC,Mark A Takano (D-Calif),78400,78400,0,Solidly Democrat/Liberal,2018
Pine Tree PAC,Bruce Poliquin (R-Maine),77900,0,77900,Solidly Republican/Conservative,2018
Freedom Project,ex-Rep. John Boehner (R-Ohio),76244,0,76244,Solidly Republican/Conservative,2018
Maintaining All Republicans in Office,Mario Diaz-Balart (R-Fla),75300,0,75300,Solidly Republican/Conservative,2018
Guardian Fund,Barry Loudermilk (R-Ga),75000,0,75000,Solidly Republican/Conservative,2018
Article 1 PAC,John A Yarmuth (D-Ky),74500,74500,0,Solidly Democrat/Liberal,2018
Seeking Justice Cmte,Doug Jones (D-Ala),73600,73600,0,Solidly Democrat/Liberal,2018
Paragraph Two PAC,Luke Messer (R-Ind),72000,0,72000,Solidly Republican/Conservative,2018
Impact Cmte,Michael R Turner (R-Ohio),72000,0,72000,Solidly Republican/Conservative,2018
Reaching for a Brighter America PAC,Robert B Aderholt (R-Ala),71000,0,71000,Solidly Republican/Conservative,2018
Let Texans Run Texas PAC,John Culberson (R-Texas),70900,0,70900,Solidly Republican/Conservative,2018
Freedom Matters PAC,Pete Olson (R-Texas),70150,0,70150,Solidly Republican/Conservative,2018
Boots PAC,Markwayne Mullin (R-Okla),69900,0,69900,Solidly Republican/Conservative,2018
Land of Opportunity PAC,Bruce Westerman (R-Ark),69000,0,69000,Solidly Republican/Conservative,2018
Commonwealth PAC (Connolly),Gerry Connolly (D-Va),68200,68200,0,Solidly Democrat/Liberal,2018
Badlands PAC,Kevin Cramer (R-ND),68100,0,68100,Solidly Republican/Conservative,2018
Reinventing a New Direction,Rand Paul (R-Ky),67500,0,67500,Solidly Republican/Conservative,2018
American Defense & Military PAC,Adam Smith (D-Wash),67500,67500,0,Solidly Democrat/Liberal,2018
Freedom & Security PAC,ex-Rep. John Kline (R-Minn),67500,0,67500,Solidly Republican/Conservative,2018
Fiscal Leadership & Knowing Economics,Jeff Flake (R-Ariz),67500,0,67500,Solidly Republican/Conservative,2018
Peach PAC,Doug Collins (R-GA),66080,0,66080,Solidly Republican/Conservative,2018
Vision for America PAC,Jackie Speier (D-Calif),66000,66000,0,Solidly Democrat/Liberal,2018
Cowboy PAC,Liz Cheney (R-Wyo),65800,0,65800,Solidly Republican/Conservative,2018
Vaquero PAC,Filemon Vela (D-Texas),65000,65000,0,Solidly Democrat/Liberal,2018
Liberty & Prosperity PAC,Rodney Frelinghuysen (R-NJ),65000,0,65000,Solidly Republican/Conservative,2018
Chesapeake PAC,Andy Harris (R-Md),65000,0,65000,Solidly Republican/Conservative,2018
Rock City PAC,Bob Corker (R-Tenn),65000,0,65000,Solidly Republican/Conservative,2018
Salt City PAC,John Katko (R-NY),64500,0,64500,Solidly Republican/Conservative,2018
Silk PAC,Bill Pascrell Jr (D-NJ),64000,64000,0,Solidly Democrat/Liberal,2018
Puget PAC,Rick Larsen (D-Wash),63700,63700,0,Solidly Democrat/Liberal,2018
Reasonable Independent Constructive & Effective,Kathleen Rice (D-NY),63500,63500,0,Solidly Democrat/Liberal,2018
Progressive Voters of America,Bernie Sanders (I-Vt),62800,62800,0,Solidly Democrat/Liberal,2018
Wells PAC,Austin Scott (R-GA),62500,0,62500,Solidly Republican/Conservative,2018
TERRI PAC,Terri A Sewell (D-Ala),60999,60999,0,Solidly Democrat/Liberal,2018
America 2.0 PAC,Tim Ryan (D-Ohio),60950,60950,0,Solidly Democrat/Liberal,2018
Progressive Americans for Democracy,Peter DeFazio (D-Ore),60800,60800,0,Solidly Democrat/Liberal,2018
Valor PAC,Brian Mast (R-Fla),60500,0,60500,Solidly Republican/Conservative,2018
Keystone Fund,Mike Doyle (D-Pa),59500,59500,0,Solidly Democrat/Liberal,2018
Bulldog Victory PAC,David Young (R-Iowa),59200,0,59200,Solidly Republican/Conservative,2018
Sea Change Leadership PAC,Karen Bass (D-Calif),59000,59000,0,Solidly Democrat/Liberal,2018
Jam PAC,Lloyd Smucker (R-Pa),59000,0,59000,Solidly Republican/Conservative,2018
HeartDocPAC,Larry Bucshon (R-Ind),57900,0,57900,Solidly Republican/Conservative,2018
America's Future Fund PAC,Jim Renacci (R-Ohio),57600,0,57600,Solidly Republican/Conservative,2018
Make It In America PAC,John Garamendi (D-Calif),57000,57000,0,Solidly Democrat/Liberal,2018
Deciding Critical Races,David Rouzer (R-NC),56800,0,56800,Solidly Republican/Conservative,2018
Kansas Leadership PAC,Roger Marshall (R-Kan),56335,0,56335,Solidly Republican/Conservative,2018
Smart Solutions PAC,Jacky Rosen (D-Nev),56100,56100,0,Solidly Democrat/Liberal,2018
Committee for a Democratic Future,Rosa L DeLauro (D-Conn),56000,56000,0,Solidly Democrat/Liberal,2018
Fund for American Exceptionalism,Todd Rokita (R-Ind),55700,0,55700,Solidly Republican/Conservative,2018
Build Our Movement,Pramila Jayapal (D-Wash),54000,54000,0,Solidly Democrat/Liberal,2018
TEDPAC,Ted Deutch (D-Fla),54000,54000,0,Solidly Democrat/Liberal,2018
Rural America Counts PAC,Rick Crawford (R-Ark),53500,0,53500,Solidly Republican/Conservative,2018
Fostering Progress PAC,Bill Foster (D-Ill),53300,53300,0,Solidly Democrat/Liberal,2018
Love PAC,Mia Love (R-Utah),52400,0,52400,Solidly Republican/Conservative,2018
WinNovember PAC,Steve Chabot (R-Ohio),52200,0,52200,Solidly Republican/Conservative,2018
Everybody Counts Everybody Matters PAC,Keith Ellison (D-Minn),52200,52200,0,Solidly Democrat/Liberal,2018
New Energy PAC,Eric Swalwell (D-Calif),51140,51140,0,Solidly Democrat/Liberal,2018
Brave PAC,David Scott (D-Ga),51000,51000,0,Solidly Democrat/Liberal,2018
Vitoria PAC,David Valadao (R-Calif),50700,0,50700,Solidly Republican/Conservative,2018
DIANE PAC,Diane Black (R-Tenn),50500,0,50500,Solidly Republican/Conservative,2018
Empire State PAC,John Faso (R-NY),50200,0,50200,Solidly Republican/Conservative,2018
Save America PAC,James E Risch (R-Idaho),50000,0,50000,Solidly Republican/Conservative,2018
Senate Victory Fund,Thad Cochran (R-Miss),50000,0,50000,Solidly Republican/Conservative,2018
Gene PAC,Gene Green (D-Texas),49500,47500,2000,Solidly Democrat/Liberal,2018
Secure PAC,Bennie G Thompson (D-Miss),49000,49000,0,Solidly Democrat/Liberal,2018
Texas First PAC,Henry Cuellar (D-Texas),48420,48420,0,Solidly Democrat/Liberal,2018
Delivering American Values in DC,David Kustoff (R-Tenn),48000,0,48000,Solidly Republican/Conservative,2018
Evergreen PAC,Suzan DelBene (D-Wash),48000,48000,0,Solidly Democrat/Liberal,2018
Victory by Investing Building & Empowering PAC,Tony Cardenas (D-Calif),48000,48000,0,Solidly Democrat/Liberal,2018
Vote to Elect Republicans Now PAC,Vernon Buchanan (R-Fla),47500,0,47500,Solidly Republican/Conservative,2018
Sawtooth PAC,Mike Simpson (R-Idaho),47500,0,47500,Solidly Republican/Conservative,2018
Making a Real Change,Marc Veasey (D-Texas),47200,47200,0,Solidly Democrat/Liberal,2018
Conservative Roundtable,George Holding (R-NC),47000,0,47000,Solidly Republican/Conservative,2018
Cuomo New York Take Back the House,Gov. Andrew Cuomo (D-NY),47000,47000,0,Solidly Democrat/Liberal,2018
Middle Class America PAC,Daniel Lipinski (D-Ill),46500,46500,0,Solidly Democrat/Liberal,2018
Battleground PAC,Mark Walker (R-NC),45830,0,45830,Solidly Republican/Conservative,2018
Leaders Only Unite PAC,Lou Barletta (R-Pa),45600,0,45600,Solidly Republican/Conservative,2018
GreggPAC,Gregg Harper (R-Miss),45500,0,45500,Solidly Republican/Conservative,2018
Midnight Sun,Don Young (R-Alaska),45500,0,45500,Solidly Republican/Conservative,2018
"Coloradans for Family, Military & Nation",Mike Coffman (R-Colo),45200,0,45200,Solidly Republican/Conservative,2018
Semper Fi PAC,Paul Cook (R-Calif),45100,0,45100,Solidly Republican/Conservative,2018
Full House PAC,ex-Rep. Joe Heck (R-Nev),45000,0,45000,Solidly Republican/Conservative,2018
VICKY PAC,Vicky Hartzler (R-Mo),44500,0,44500,Solidly Republican/Conservative,2018
Believe in Life Liberty Yourself,Billy Long (R-Mo),44200,0,44200,Solidly Republican/Conservative,2018
Nova PAC,Barbara Comstock (R-Va),43900,0,43900,Solidly Republican/Conservative,2018
Blue Power,Don Norcross (D-NJ),42700,42700,0,Solidly Democrat/Liberal,2018
Democracy Summer Leadership PAC,Jamie Raskin (D-Md),43529,43529,0,Solidly Democrat/Liberal,2018
Congressional House Republicans In Service PAC,Chris Collins (R-NY),43500,0,43500,Solidly Republican/Conservative,2018
Husky PAC,Joe Courtney (D-Conn),43500,43500,0,Solidly Democrat/Liberal,2018
Blue Line PAC,Mike Quigley (D-Ill),43036,43036,0,Solidly Democrat/Liberal,2018
Promise Pac,Marcia L Fudge (D-Ohio),43000,43000,0,Solidly Democrat/Liberal,2018
BACON PAC,Don Bacon (R-Neb),42750,0,42750,Solidly Republican/Conservative,2018
Republicans in Congress Empowering America,Tom Rice (R-SC),42700,0,42700,Solidly Republican/Conservative,2018
Lincoln PAC,ex-Rep. Mark Kirk (R-Ill),42700,10000,32700,Leans Republican/Conservative,2018
Truth Is Markets Work Fund,Tim Walberg (R-Mich),42000,0,42000,Solidly Republican/Conservative,2018
Spirit of '76 PAC,Dan Crenshaw (R-Texas),41700,0,41700,Solidly Republican/Conservative,2018
Patriot PAC (Palazzo),Steven Palazzo (R-Miss),41300,2500,38800,Solidly Republican/Conservative,2018
Defending America's Values Everywhere,David Schweikert (R-Ariz),41000,0,41000,Solidly Republican/Conservative,2018
GWEN PAC,Gwen Moore (D-Wis),41000,41000,0,Solidly Democrat/Liberal,2018
Funding Developing Leadership PAC,Frank D Lucas (R-Okla),40500,0,40500,Solidly Republican/Conservative,2018
Star PAC,John Bergman (R-Mich),40500,0,40500,Solidly Republican/Conservative,2018
Fearless PAC,Jared Polis (D-Colo),40250,40250,0,Solidly Democrat/Liberal,2018
Individuals Dedicated to Ethics & Science,Diana DeGette (D-Colo),39669,39669,0,Solidly Democrat/Liberal,2018
At the Table!,Grace Meng (D-NY),38000,38000,0,Solidly Democrat/Liberal,2018
Restoring Our Nation PAC,Ron Estes (R-Kan),39000,0,39000,Solidly Republican/Conservative,2018
CARTER PAC,John Carter (R-Texas),38900,0,38900,Solidly Republican/Conservative,2018
Long Leaf Pine PAC,ex-Sen. Kay R Hagan (D-NC),38000,38000,0,Solidly Democrat/Liberal,2018
BYRNE PAC,Bradley Byrne (R-Ala),38000,0,38000,Solidly Republican/Conservative,2018
American Revival PAC,Mike Johnson (R-La),37700,0,37700,Solidly Republican/Conservative,2018
Hitting Home PAC,South Bend Mayor Pete Buttigieg (D),37000,37000,0,Solidly Democrat/Liberal,2018
Betty PAC,Betty McCollum (D-Minn),36500,36500,0,Solidly Democrat/Liberal,2018
People Helping People,Maxine Waters (D-Calif),36000,36000,0,Solidly Democrat/Liberal,2018
Searchlight Leadership Fund,ex-Sen. Harry Reid (D-Nev),36000,36000,0,Solidly Democrat/Liberal,2018
Build Our Future,Francis Rooney (R-Fla),35300,0,35300,Solidly Republican/Conservative,2018
Relentless Positive Action PAC,Gov. Rick Snyder (R-Mich),35200,0,35200,Solidly Republican/Conservative,2018
America Unlimited,Ted Yoho (R-Fla),35000,0,35000,Solidly Republican/Conservative,2018
Science Energy & Environment Change PAC,Jerry McNerney (D-Calif),34900,34900,0,Solidly Democrat/Liberal,2018
Building & Restoring the American Dream,Brad Wenstrup (R-Ohio),34700,0,34700,Solidly Republican/Conservative,2018
Build America PAC,Gregory W Meeks (D-NY),34500,34500,0,Solidly Democrat/Liberal,2018
LLEGO-PAC,Ruben Gallego (D-Ariz),34100,34100,0,Solidly Democrat/Liberal,2018
Building Opportunities for a Stronger Tomorrow,Mike Bost (R-Ill),32900,0,32900,Solidly Republican/Conservative,2018
Free Markets PAC,Robert Pittenger (R-NC),32900,0,32900,Solidly Republican/Conservative,2018
America's First PAC,Rob Wittman (R-VA),32600,0,32600,Solidly Republican/Conservative,2018
Patriots Leading a Majority,Patrick Meehan (R-Pa),32500,0,32500,Solidly Republican/Conservative,2018
Good Friends PAC,Suzanne Bonamici (D-Ore),32500,32500,0,Solidly Democrat/Liberal,2018
Valley First Leadership PAC,Jim Costa (D-Calif),32100,32100,0,Solidly Democrat/Liberal,2018
Fightin' Ninth PAC,Morgan Griffith (R-VA),32000,0,32000,Solidly Republican/Conservative,2018
DBM PAC,David McKinley (R-WVa),31000,0,31000,Solidly Republican/Conservative,2018
Bridge the Gap PAC,Brad Schneider (D-Ill),31000,31000,0,Solidly Democrat/Liberal,2018
Opportunity First PAC,ex-San Antonio Mayor Julian Castro (D),30700,30700,0,Solidly Democrat/Liberal,2018
Country First PAC,John McCain (R-Ariz),30565,0,30565,Solidly Republican/Conservative,2018
National Security Democrats PAC,ex-Rep Steve Israel (D-NY),30458,30458,0,Solidly Democrat/Liberal,2018
T-MAC PAC,Thomas MacArthur (R-NJ),30400,0,30400,Solidly Republican/Conservative,2018
Americans for Republican Leadership,Leonard Lance (R-NJ),30000,0,30000,Solidly Republican/Conservative,2018
GOLD PAC,Sanford Bishop Jr (D-Ga),30000,30000,0,Solidly Democrat/Liberal,2018
Ken PAC,Kenny Marchant (R-Texas),29700,0,29700,Solidly Republican/Conservative,2018
AnniePAC,Ann McLane Kuster (D-NH),29500,29500,0,Solidly Democrat/Liberal,2018
Giving Us Security PAC,Gus Bilirakis (R-Fla),29500,0,29500,Solidly Republican/Conservative,2018
We Ignite New Energy PAC,Justin Fareed (R-Calif),29400,0,29400,Solidly Republican/Conservative,2018
Southern California Fund,Brad Sherman (D-Calif),29400,29400,0,Solidly Democrat/Liberal,2018
Reviving American Jobs Again,Raja Krishnamoorthi (D-Ill),28917,28917,0,Solidly Democrat/Liberal,2018
Mac PAC,James P McGovern (D-Mass),28700,23500,5200,Leans Democrat/Liberal,2018
Kelly PAC,ex-Sen. Kelly Ayotte (R-NH),28500,1000,27500,Solidly Republican/Conservative,2018
Building Renewal in America Now,Brian Babin (R-Texas),28500,0,28500,Solidly Republican/Conservative,2018
Lead Your Nation Now PAC,Lynn Jenkins (R-Kan),28000,0,28000,Solidly Republican/Conservative,2018
Longhorn PAC,Lamar Smith (R-Texas),28000,0,28000,Solidly Republican/Conservative,2018
Peace Through Strength PAC,Duncan D Hunter (R-Calif),27500,0,27500,Solidly Republican/Conservative,2018
TN4U PAC,Scott Desjarlais (R-Tenn),27500,0,27500,Solidly Republican/Conservative,2018
CASTLEPAC,ex-Rep. Michael N Castle (R-Del),27100,0,27100,Solidly Republican/Conservative,2018
SAC PAC,Doris O Matsui (D-Calif),27000,27000,0,Solidly Democrat/Liberal,2018
Carolyn's PAC,Carolyn B Maloney (D-NY),27000,27000,0,Solidly Democrat/Liberal,2018
HANDEL PAC,Karen Handel (R-Ga),27000,0,27000,Solidly Republican/Conservative,2018
GOALPAC,Sander Levin (D-Mich),26900,26900,0,Solidly Democrat/Liberal,2018
Serving Our Country PAC,Salud Carbajal (D-Calif),26700,26700,0,Solidly Democrat/Liberal,2018
Utah First PAC,John Curtis (R-Utah),26200,0,26200,Solidly Republican/Conservative,2018
LATTA PAC,Robert E Latta (R-Ohio),26100,0,26100,Solidly Republican/Conservative,2018
Common Sense Democrat PAC,Stephen F Lynch (D-Mass),26000,26000,0,Solidly Democrat/Liberal,2018
Friends of Chaffetz,ex-Rep. Jason Chaffetz (R-Utah),25700,0,25700,Solidly Republican/Conservative,2018
"Jobs, Energy & Our Founding Fathers PAC",Jeff Duncan (R-SC),25400,0,25400,Solidly Republican/Conservative,2018
Republicans Preserving Our Majority PAC,Paul Mitchell (R-Mich),25000,0,25000,Solidly Republican/Conservative,2018
Defending American Values Everywhere,David P Joyce (R-Ohio),25000,0,25000,Solidly Republican/Conservative,2018
Reason to Believe PAC,ex-Gov. Deval Patrick (D-Mass),25000,25000,0,Solidly Democrat/Liberal,2018
Spirit of America PAC,ex-Sen. John Kerry (D-Mass),24700,24700,0,Solidly Democrat/Liberal,2018
New Voice PAC,Joyce Beatty (D-Ohio),24500,24500,0,Solidly Democrat/Liberal,2018
Jenni Achieving Goals & Opportunities,Commissioner Jenniffer Gonzalez (3-PR),23900,0,23900,Solidly Republican/Conservative,2018
Go PAC Go,Mike Gallagher (R-Wis),23600,0,23600,Solidly Republican/Conservative,2018
Give Me Liberty PAC,Dana Rohrabacher (R-Calif),23000,0,23000,Solidly Republican/Conservative,2018
Razor PAC,Steve Womack (R-Ark),23000,0,23000,Solidly Republican/Conservative,2018
Belief In Life & Liberty,Bill Johnson (R-Ohio),22800,0,22800,Solidly Republican/Conservative,2018
Bringing America Together,Brian Fitzpatrick (R-Pa),22700,0,22700,Solidly Republican/Conservative,2018
Leadership Matters for America,ex-Gov. Chris Christie (R-NJ),22700,0,22700,Solidly Republican/Conservative,2018
Making Americans Count PAC,Matt Cartwright (D-Pa),22600,20100,2500,Solidly Democrat/Liberal,2018
Bill PAC (Flores),Bill Flores (R-Texas),22500,0,22500,Solidly Republican/Conservative,2018
Immigration Reform Fund,Luis V Gutierrez (D-Ill),22200,21200,1000,Solidly Democrat/Liberal,2018
COMER PAC,James Comer (R-Ky),22000,0,22000,Solidly Republican/Conservative,2018
Dougle Eagle PAC,Steve Knight (R-Calif),22000,0,22000,Solidly Republican/Conservative,2018
Mass PAC,Michael E Capuano (D-Mass),22000,22000,0,Solidly Democrat/Liberal,2018
Together We Rise,Judy Chu (D-Calif),22000,22000,0,Solidly Democrat/Liberal,2018
Together United for Liberty Integrity & Prosperity,John Moolenaar (R-Mich),21900,0,21900,Solidly Republican/Conservative,2018
Pioneer PAC (Rob Bishop),Rob Bishop (R-Utah),21500,0,21500,Solidly Republican/Conservative,2018
Your Voice Counts,Mark R Meadows (R-NC),21000,0,21000,Solidly Republican/Conservative,2018
Athena PAC,Kathy Castor (D-Fla),21000,21000,0,Solidly Democrat/Liberal,2018
Hudson Valley PAC (Maloney),Sean Patrick Maloney (D-NY),20800,20800,0,Solidly Democrat/Liberal,2018
Senate Majority Fund,ex-Sen. Jon L. Kyl (R-Ariz),20700,0,20700,Solidly Republican/Conservative,2018
Milk River PAC,Yvette D Clarke (D-NY),20000,20000,0,Solidly Democrat/Liberal,2018
Innovate PAC,Mark Desaulnier (D-Calif),19500,19500,0,Solidly Democrat/Liberal,2018
"NorCal Water, Jobs, Liberty",Doug LaMalfa (R-Calif),19400,0,19400,Solidly Republican/Conservative,2018
Defend & Uphold Our Nation Now,Neal Dunn (R-Fla),19000,0,19000,Solidly Republican/Conservative,2018
New Republican Majority Fund,ex-Sen. Trent Lott (R-Miss),18700,0,18700,Solidly Republican/Conservative,2018
Win Back Your State,ex-Gov. Martin O'Malley (D-MD),18328,18328,0,Solidly Democrat/Liberal,2018
United for Progress Leadership Cmte,ex-Rep. Jerry F. Costello (D-Ill),18200,18200,0,Solidly Democrat/Liberal,2018
RedwingMCPAC,ex-Rep. Tim Murphy (R-Pa),18000,0,18000,Solidly Republican/Conservative,2018
Pinnacle PAC,ex-Rep. John Campbell (R-Calif),18000,0,18000,Solidly Republican/Conservative,2018
One Generation PAC,Kenneth R Buck (R-Colo),18000,0,18000,Solidly Republican/Conservative,2018
Big Sky Values PAC,Gov. Steve Bullock (D-Mont),17900,17900,0,Solidly Democrat/Liberal,2018
Restore Democracy,Rick Nolan (D-Minn),17800,17800,0,Solidly Democrat/Liberal,2018
Maple PAC,Peter Welch (D-VT),17500,17500,0,Solidly Democrat/Liberal,2018
Luchadora PAC,Nanette Barragan (D-Calif),17500,17500,0,Solidly Democrat/Liberal,2018
Old North State PAC,Ted Budd (R-NC),17400,0,17400,Solidly Republican/Conservative,2018
Cincinnatus PAC,Cincinnati Mayor John Cranley (D),17000,17000,0,Solidly Democrat/Liberal,2018
Visionary PAC,Robin Kelly (D-Ill),17000,17000,0,Solidly Democrat/Liberal,2018
First Principles Fund,Ron DeSantis (R-Fla),17000,0,17000,Solidly Republican/Conservative,2018
NORM PAC,ex-Rep. Norm Dicks (D-Wash),17000,16000,1000,Solidly Democrat/Liberal,2018
New Energy In Washington House PAC,Daniel Milton Newhouse (R-Wash),16500,0,16500,Solidly Republican/Conservative,2018
Fairness PAC,Mayor Bill de Blasio (D-NY),16198,16198,0,Solidly Democrat/Liberal,2018
Sheriff PAC,Dave Reichert (R-Wash),16032,0,16032,Solidly Republican/Conservative,2018
SALMON PAC,ex-Rep. Matt Salmon (R-Ariz),16000,0,16000,Solidly Republican/Conservative,2018
Fighting for South Texas,Vicente Gonzalez (D-Texas),15800,15800,0,Solidly Democrat/Liberal,2018
America Now,Andre Carson (D-Ind),15500,15500,0,Solidly Democrat/Liberal,2018
Renewing the American Dream PAC,Tim Walz (D-Minn),15400,15400,0,Solidly Democrat/Liberal,2018
Keeping Republican Ideas Strong Timely,Kristi Noem (R-SD),15000,0,15000,Solidly Republican/Conservative,2018
Calumet PAC,Pete Visclosky (D-Ind),15000,15000,0,Solidly Democrat/Liberal,2018
Make Opportunity PAC,Mo Brooks (R-Ala),15000,0,15000,Solidly Republican/Conservative,2018
Patriots In Action,Roger Williams (R-Texas),15000,0,15000,Solidly Republican/Conservative,2018
R Senate PAC,John Cornyn (R-Texas),15000,0,15000,Solidly Republican/Conservative,2018
Lone Star Liberty Fund,John Lee Ratcliffe (R-Texas),15000,0,15000,Solidly Republican/Conservative,2018
ELEPAC,Eliot L Engel (D-NY),15000,15000,0,Solidly Democrat/Liberal,2018
Medicare for All PAC,Pramila Jayapal (D-Wash),15000,15000,0,Solidly Democrat/Liberal,2018
Moving America's Republicans Into Number One,Tom Marino (R-Pa),14800,0,14800,Solidly Republican/Conservative,2018
All America PAC,ex-Sen. Evan Bayh (D-Ind),14500,14500,0,Solidly Democrat/Liberal,2018
PEM PAC,ex-Rep. Patrick Murphy (D-Fla),14500,14500,0,Solidly Democrat/Liberal,2018
SCOTT PAC,ex-Rep. Scott Garrett (R-NJ),14100,0,14100,Solidly Republican/Conservative,2018
Strengthening Virginia's Working Families PAC,Bobby Scott (D-Va),14000,14000,0,Solidly Democrat/Liberal,2018
Reagan Heritage PAC,Randy Hultgren (R-Ill),13700,0,13700,Solidly Republican/Conservative,2018
Pelican PAC,John Kennedy (R-La),13400,0,13400,Solidly Republican/Conservative,2018
Frontera Vision PAC,Veronica Escobar (D-Texas),13400,13400,0,Solidly Democrat/Liberal,2018
Eagle PAC,ex-Rep. Bob Dold (R-Ill),13277,0,13277,Solidly Republican/Conservative,2018
Stand PAC,Barry Loudermilk (R-Ga),13000,0,13000,Solidly Republican/Conservative,2018
Leadership Responsibility & Action PAC,Lucille Roybal-Allard (D-Calif),13000,13000,0,Solidly Democrat/Liberal,2018
Forever YOUNG PAC,State Rep. Young Kim (R-Calif),12800,0,12800,Solidly Republican/Conservative,2018
Buckeye Patriot PAC,ex-Rep. David Hobson (R-Ohio),12500,0,12500,Solidly Republican/Conservative,2018
Jerry Lewis PAC,ex-Rep. Jerry Lewis (R-Calif),12000,0,12000,Solidly Republican/Conservative,2018
Mary Bono Cmte,ex-Rep. Mary Bono Mack (R-Calif),12000,0,12000,Solidly Republican/Conservative,2018
Ocean State PAC,Jim Langevin (D-RI),12000,12000,0,Solidly Democrat/Liberal,2018
Harvest PAC,ex-Rep. Allen Boyd (D-Fla),12000,11500,500,Solidly Democrat/Liberal,2018
Democrats Against Waste in Govt PAC,ex-Rep. John Barrow (D-Ga),12000,12000,0,Solidly Democrat/Liberal,2018
Progressives Advancing United Leadership,Paul Tonko (D-NY),12000,12000,0,Solidly Democrat/Liberal,2018
Jobs Unite Labor & Industry in America,Julia Brownley (D-Calif),12000,12000,0,Solidly Democrat/Liberal,2018
Freedom 21: Fighting for Freedom/21st Century,Chris Stewart (R-Utah),12000,0,12000,Solidly Republican/Conservative,2018
BFB PAC,Brendan Boyle (D-Pa),12000,12000,0,Solidly Democrat/Liberal,2018
Justice Opportunity Strength Honor PAC,State Treasurer Josh Mandel (R-Ohio),11950,0,11950,Solidly Republican/Conservative,2018
For Our Republic's Traditions Fund,Jeff Fortenberry (R-Neb),11900,0,11900,Solidly Republican/Conservative,2018
Trent's Troops PAC,Trent Kelly (R-Miss),11700,0,11700,Solidly Republican/Conservative,2018
Deeds Not Words PAC,Steven Russell (R-Okla),11700,0,11700,Solidly Republican/Conservative,2018
Role Model Leadership PAC,Frederica Wilson (D-Fla),11700,11700,0,Solidly Democrat/Liberal,2018
Growing Our Own Dynamic Economy Now,State Rep. Lance Gooden (R-Texas),11700,0,11700,Solidly Republican/Conservative,2018
Come Back PAC,Tim Murphy (R-Pa),11651,0,11651,Solidly Republican/Conservative,2018
Committee to Strengthen America,ex-Rep. Robert E. Andrews (D-NJ),11500,11500,0,Solidly Democrat/Liberal,2018
Citizens Strengthening Our Majority in the House,Chris Smith (R-NJ),11100,0,11100,Solidly Republican/Conservative,2018
Toward Tomorrow PAC,Joaquin Castro (D-Texas),11000,11000,0,Solidly Democrat/Liberal,2018
Taking an Independent Perspective Together Our Ntn,Scott Tipton (R-Colo),11000,0,11000,Solidly Republican/Conservative,2018
Limitless Horizons PAC,Tom O'Halleran (D-Ariz),11000,11000,0,Solidly Democrat/Liberal,2018
Giddy Up PAC,Gov. John Hickenlooper (D-Colo),11000,11000,0,Solidly Democrat/Liberal,2018
DEB PAC,Debbie Lesko (R-Ariz),10700,0,10700,Solidly Republican/Conservative,2018
Common Good PAC,Tom Suozzi (D-NY),10400,10400,0,Solidly Democrat/Liberal,2018
Just Lead PAC,Jason Lewis (R-Minn),10400,0,10400,Solidly Republican/Conservative,2018
Building Effective Responsible Govt,ex-Rep. Rick Berg (R-ND),10100,0,10100,Solidly Republican/Conservative,2018
GatorPAC,Rob Maness (R-La),10000,0,10000,Solidly Republican/Conservative,2018
Building & Restoring America Together,Dave Brat (R-Va),10000,0,10000,Solidly Republican/Conservative,2018
New Opportunity for Real Monumental Action,Norma Torres (D-Calif),10000,10000,0,Solidly Democrat/Liberal,2018
Conservatives Restoring Excellence,ex-Rep. Renee Ellmers (R-NC),10000,0,10000,Solidly Republican/Conservative,2018
Truedem Leadership Fund,Marcy Kaptur (D-Ohio),10000,10000,0,Solidly Democrat/Liberal,2018
Majority In Congress PAC,ex-Rep. John L Mica (R-Fla),10000,0,10000,Solidly Republican/Conservative,2018
Together for Our Majority,ex-Rep. Tom Reynolds (R-NY),9500,3000,6500,Leans Republican/Conservative,2018
DENT PAC,Charlie Dent (R-Pa),9500,0,9500,Solidly Republican/Conservative,2018
Partnership for America,Frank A LoBiondo (R-NJ),9484,0,9484,Solidly Republican/Conservative,2018
First Team PAC,Tom Rooney (R-Fla),9400,0,9400,Solidly Republican/Conservative,2018
Road to Victory PAC,John J Duncan Jr (R-Tenn),9000,0,9000,Solidly Republican/Conservative,2018
Building Our Base - Bob PAC,Bob Gibbs (R-Ohio),9000,0,9000,Solidly Republican/Conservative,2018
RVFPAC,State Sen. Guy Reschenthaler (R-Pa),9000,0,9000,Solidly Republican/Conservative,2018
Time to Unite Lead & Serve with Integrity,Tulsi Gabbard (D-Hawaii),8700,8700,0,Solidly Democrat/Liberal,2018
New South Leadership PAC,G K Butterfield (D-NC),8500,8500,0,Solidly Democrat/Liberal,2018
SkiPAC,Ex-Rep. Jim Matheson (D-Utah),8100,8100,0,Solidly Democrat/Liberal,2018
Mustang PAC,Greg Pence (R-Ind),8100,0,8100,Solidly Republican/Conservative,2018
Strong Economy & National Security PAC,Sean Flynn (R-Calif),8100,0,8100,Solidly Republican/Conservative,2018
Bulldog PAC,Jodey Arrington (R-Texas),8000,0,8000,Solidly Republican/Conservative,2018
Accountability PAC,Bill Posey (R-Fla),8000,0,8000,Solidly Republican/Conservative,2018
Ponderosa PAC,Mark Amodei (R-Nev),8000,0,8000,Solidly Republican/Conservative,2018
OC Jobs & Education,Lou Correa (D-Calif),8000,8000,0,Solidly Democrat/Liberal,2018
Block By Block PAC,Dwight Evans (D-Pa),8000,8000,0,Solidly Democrat/Liberal,2018
Empowering Each Community PAC,Elijah E Cummings (D-Md),7500,7500,0,Solidly Democrat/Liberal,2018
Acton PAC,ex-Rep. Lynn A Westmoreland (R-Ga),7500,0,7500,Solidly Republican/Conservative,2018
Progress PAC,Nydia M Velazquez (D-NY),7500,7500,0,Solidly Democrat/Liberal,2018
Building A Majority PAC,ex-Sen. Barbara A Mikulski (D-Md),7000,2000,5000,Leans Republican/Conservative,2018
We the People PAC,Ex-Rep. Allyson Schwartz (D-Pa),7000,7000,0,Solidly Democrat/Liberal,2018
Concerned Americans for Freedom & Opportunity,Adrian Smith (R-Neb),7000,0,7000,Solidly Republican/Conservative,2018
Doing Our Utmost For God Liberty & Security,Douglas L Lamborn (R-Colo),7000,0,7000,Solidly Republican/Conservative,2018
Livable Communities PAC,Raul M Grijalva (D-Ariz),6750,6750,0,Solidly Democrat/Liberal,2018
Developing a New Generation PAC,Stephanie Murphy (D-Fla),6700,6700,0,Solidly Democrat/Liberal,2018
Democrats Time In Nevada,Dina Titus (D-Nev),6500,6500,0,Solidly Democrat/Liberal,2018
LA PAC,ex-Rep. Henry Waxman (D-Calif),6500,6500,0,Solidly Democrat/Liberal,2018
1848 PAC,Glenn S Grothman (R-Wis),6400,0,6400,Solidly Republican/Conservative,2018
Reform Government Leadership PAC,Lt Gov Carlos Lopez-Cantera (R-Fla),6200,0,6200,Solidly Republican/Conservative,2018
Building a National Knowledgeable Security PAC,Jim Banks (R-Ind),6000,0,6000,Solidly Republican/Conservative,2018
Community PAC,Hank Johnson (D-Ga),6000,6000,0,Solidly Democrat/Liberal,2018
I-PAC,David Loebsack (D-Iowa),6000,6000,0,Solidly Democrat/Liberal,2018
Defending America's Future,Trent Franks (R-Ariz),6000,0,6000,Solidly Republican/Conservative,2018
Great American Fund,ex-Rep. Dan Boren (D-Okla),6000,3000,3000,On the fence,2018
JIMMY PAC,Jimmy Panetta (D-Calif),6000,6000,0,Solidly Democrat/Liberal,2018
Ready to Work PAC,Sheila Jackson Lee (D-Texas),5988,5988,0,Solidly Democrat/Liberal,2018
Beehive PAC,Jason Chaffetz (R-Utah),5500,0,5500,Solidly Republican/Conservative,2018
Mountain State Victory PAC,Evan Jenkins (R-WVa),5400,0,5400,Solidly Republican/Conservative,2018
MI14,Brenda Lawrence (D-Mich),5400,5400,0,Solidly Democrat/Liberal,2018
JustinPAC,Justin Amash (R-Mich),5400,0,5400,Solidly Republican/Conservative,2018
Gforce PAC,Greg Gianforte (R-Mont),5200,0,5200,Solidly Republican/Conservative,2018
Takin Back America,ex-Rep. Todd Akin (R-Mo),5200,0,5200,Solidly Republican/Conservative,2018
Guts PAC,ex-Rep. Alan Grayson (D-Fla),5000,5000,0,Solidly Democrat/Liberal,2018
Conservative Principles PAC,Steven A. King (R-Iowa),5000,0,5000,Solidly Republican/Conservative,2018
Leading Orange County PAC,ex-Rep. Loretta Sanchez (D-Calif),5000,5000,0,Solidly Democrat/Liberal,2018
13th Colony Leadership Cmte,ex-Rep. Jack Kingston (R-Ga),5000,0,5000,Solidly Republican/Conservative,2018
America Forward PAC,John Conyers Jr (D-Mich),5000,5000,0,Solidly Democrat/Liberal,2018
Little PAC,Colleen Hanabusa (D-Hawaii),5000,5000,0,Solidly Democrat/Liberal,2018
Kander PAC,ex-Secretary of State Jason Kander (R-Mo),5000,5000,0,Solidly Democrat/Liberal,2018
Right To Rise PAC,ex-Gov. Jeb Bush (R-Fla),5000,0,5000,Solidly Republican/Conservative,2018
America's Cmte for Excellence,Ralph Abraham (R-La),5000,0,5000,Solidly Republican/Conservative,2018
Effective Leadership Enhancing Communities Today,Elizabeth Esty (D-Conn),5000,5000,0,Solidly Democrat/Liberal,2018
Catalyst PAC,ex-Rep. Trey Radel (R-Fla),5000,0,5000,Solidly Republican/Conservative,2018
Strong Country for Today & Tomorrow,ex-Sen. Scott Brown (R-Mass),4700,0,4700,Solidly Republican/Conservative,2018
Buckeye PAC (Gonzalez),Anthony Gonzalez (R-Ohio),4500,0,4500,Solidly Republican/Conservative,2018
Never Surrender PAC,State Sen. Mark Green (R-Tenn),4000,0,4000,Solidly Republican/Conservative,2018
Above the Best PAC,Anthony Brown (D-Md),4000,4000,0,Solidly Democrat/Liberal,2018
USA First PAC,Ben Carson (R-),4000,0,4000,Solidly Republican/Conservative,2018
Rob Bonta for Assembly 2018,Assemblyman Rob Bonta (D-Calif),4000,4000,0,Solidly Democrat/Liberal,2018
Building Innovative Good Government Solutions PAC,Andy Biggs (R-Ariz),4000,0,4000,Solidly Republican/Conservative,2018
KITPAC 2,ex-Sen. Christopher S. 'Kit' Bond (R-MO),4000,0,4000,Solidly Republican/Conservative,2018
Who Dat PAC,Cedric Richmond (D-La),4000,4000,0,Solidly Democrat/Liberal,2018
American Freedom PAC,ex-Rep. Tim Huelskamp (R-Kan),3985,0,3985,Solidly Republican/Conservative,2018
Bring a Challenger for Pennsylvania Congressman,Andrew Zahalsky (R-Pa),3500,3500,0,Solidly Democrat/Liberal,2018
South Florida First,ex-Rep. Ileana Ros-Lehtinen (R-Fla),3500,0,3500,Solidly Republican/Conservative,2018
Arch Leadership PAC,ex-Rep. Russ Carnahan (D-Mo),3500,0,3500,Solidly Republican/Conservative,2018
Wolf Pack,Emanuel Cleaver (D-Mo),3200,3200,0,Solidly Democrat/Liberal,2018
RWA Fund,Richard W Allen (R-Ga),3000,0,3000,Solidly Republican/Conservative,2018
Secure America's Majority PAC,Sam Johnson (R-Texas),2879,0,2879,Solidly Republican/Conservative,2018
Kentucky Forward PAC,ex-Rep. Ben Chandler (D-Ky),2700,2700,0,Solidly Democrat/Liberal,2018
First Capital PAC,Scott Perry (R-Pa),2700,0,2700,Solidly Republican/Conservative,2018
Rebuilding America's Trust PAC,Rob Woodall (R-Ga),2700,0,2700,Solidly Republican/Conservative,2018
Dakota Leadership PAC,Dusty Johnson (R-SD),2700,0,2700,Solidly Republican/Conservative,2018
Strengthening the American Republic PAC,John Rutherford (R-Fla),2700,0,2700,Solidly Republican/Conservative,2018
Elbert Guillory's America,ex-State Sen. Elbert Guillory (R-La),2600,0,2600,Solidly Republican/Conservative,2018
Point PAC,Drew Ferguson (R-Ga),2500,0,2500,Solidly Republican/Conservative,2018
Brighter Futures PAC,Blake Farenthold (R-Texas),2500,0,2500,Solidly Republican/Conservative,2018
Every Republican is Crucial PAC,ex-Rep. Eric Cantor (R-Va),2500,0,2500,Solidly Republican/Conservative,2018
Committee For Southwest Virginia,ex-Rep. Rick Boucher (D-Va),2500,2500,0,Solidly Democrat/Liberal,2018
GUEST PAC,Michael Patrick Guest (R-Miss),2500,0,2500,Solidly Republican/Conservative,2018
Del PAC,ex-Rep. John Carney (D-Del),2300,2300,0,Solidly Democrat/Liberal,2018
Deep Blue,ex-Rep. Joe Sestak (D-Pa),2200,2200,0,Solidly Democrat/Liberal,2018
All Power to The People PAC,Bobby L Rush (D-Ill),2000,2000,0,Solidly Democrat/Liberal,2018
New York Jobs PAC,ex-Rep. Steve Israel (D-NY),2000,2000,0,Solidly Democrat/Liberal,2018
Louisiana Reform PAC,ex-Sen. David Vitter (R-LA),2000,0,2000,Solidly Republican/Conservative,2018
VictoryPAC,ex-Rep. Gary Ackerman (D-NY),2000,2000,0,Solidly Democrat/Liberal,2018
I Got Your Back PAC,Lisa Blunt Rochester (D-Del),2000,2000,0,Solidly Democrat/Liberal,2018
Defend America Now,Dan Donovan (R-NY),2000,0,2000,Solidly Republican/Conservative,2018
Keystone Leadership PAC,ex-Rep. Michael G Fitzpatrick (R-Pa),2000,0,2000,Solidly Republican/Conservative,2018
Helping All Republicans This Key Election Year,ex-State Rep. Diane Harkey (R-Calif),2000,0,2000,Solidly Republican/Conservative,2018
Taking the Hill PAC,ex-Rep. Patrick J. Murphy (D-Pa),2000,2000,0,Solidly Democrat/Liberal,2018
Capitol Heel PAC,Alma Adams (D-NC),1800,1800,0,Solidly Democrat/Liberal,2018
Protecting America Under Law,Paul Gosar (R-Ariz),1700,0,1700,Solidly Republican/Conservative,2018
Virginia Leadership PAC,ex-Rep. Jim Moran (D-VA),1620,1620,0,Solidly Democrat/Liberal,2018
Building Infrastructure Harnessing Our Priorities,ex-Rep. Timothy H Bishop (D-NY),1500,1500,0,Solidly Democrat/Liberal,2018
G PAC,Mayor Greg Fischer (D-Louisville),1500,1500,0,Solidly Democrat/Liberal,2018
Port PAC,Alan Lowenthal (D-Calif),1500,1500,0,Solidly Democrat/Liberal,2018
Americans For Legislative Excellence PAC,Alex Mooney (R-WVa),1335,0,1335,Solidly Republican/Conservative,2018
TROTTER PAC,Dave Trott (R-Mich),1262,0,1262,Solidly Republican/Conservative,2018
Jimmy Field Campaign,Public Service Commissioner Jimmy Field (R-La),1250,0,1250,Solidly Republican/Conservative,2018
Freedom for All Americans,Rand Paul (R-Ky),1250,0,1250,Solidly Republican/Conservative,2018
Building American Conservatism PAC,Randy Weber (R-Texas),1000,0,1000,Solidly Republican/Conservative,2018
Arizona Sunrise PAC,ex-Rep. Matt Salmon (R-Ariz),1000,0,1000,Solidly Republican/Conservative,2018
Louise's PAC,Louise M Slaughter (D-NY),1000,1000,0,Solidly Democrat/Liberal,2018
Taking Our Majority PAC,Tom McClintock (R-Calif),1000,0,1000,Solidly Republican/Conservative,2018
KPAC,ex-Sen. Kay Bailey Hutchison (R-Texas),1000,0,1000,Solidly Republican/Conservative,2018
Ander PAC,ex-Rep. Ander Crenshaw (R-Fla),1000,0,1000,Solidly Republican/Conservative,2018
FairPAC,ex-Rep. John Linder (R-Ga),1000,0,1000,Solidly Republican/Conservative,2018
Fund for American Opportunity,ex-Sen. Spencer Abraham (R-Mich),1000,0,1000,Solidly Republican/Conservative,2018
Education & Opportunity Fund,ex-Rep. David Wu (D-Ore),1000,1000,0,Solidly Democrat/Liberal,2018
PITTSPAC,ex-Rep. Joe Pitts (R-Pa),1000,0,1000,Solidly Republican/Conservative,2018
MACK PAC,ex-Rep. Connie Mack (R-Fla),1000,0,1000,Solidly Republican/Conservative,2018
Because Women Can,Bonnie Coleman (D-NJ),750,750,0,Solidly Democrat/Liberal,2018
Committee for the Preservation of Capitalism,ex-Rep. Charles W Boustany Jr (R-La),600,0,600,Solidly Republican/Conservative,2018
Common Good Fund,ex-Rep. Jim McDermott (D-Wash),500,500,0,Solidly Democrat/Liberal,2018
Seagrass PAC,ex-Rep. David Jolly (R-Fla),500,0,500,Solidly Republican/Conservative,2018
PEM PAC,ex-Rep. Patrick Murphy (D-Fla),500,500,0,Solidly Democrat/Liberal,2018
Tar Heel PAC,ex-Rep. Mike McIntyre (D-NC),250,250,0,Solidly Democrat/Liberal,2018
Middle Ground PAC,ex-Rep. Timothy Johnson (R-Ill),250,0,250,Solidly Republican/Conservative,2018
Practical Solutions for America,Mary Perry (R-Nev),58,0,58,Solidly Republican/Conservative,2018
Voice for Freedom,ex-Rep. Tom Price (R-Ga),-5000,0,-5000,Solidly Republican/Conservative,2018
