pac_name,affiliate,total,dem,repub,lean,year
Majority Cmte PAC,Kevin McCarthy (R-Calif),2067595,0,2067595,Solidly Republican/Conservative,2016
Prosperity Action,Paul Ryan (R-Wis),1326238,0,1326238,Solidly Republican/Conservative,2016
AmeriPAC: The Fund for a Greater America,Steny H. Hoyer (D-Md),1095799,1095799,0,Solidly Democrat/Liberal,2016
Eye of the Tiger PAC,Steve Scalise (R-La),941985,0,941985,Solidly Republican/Conservative,2016
More Conservatives PAC,Patrick McHenry (R-NC),702000,0,702000,Solidly Republican/Conservative,2016
Off The Sidelines,Kirsten Gillibrand (D-NY),692750,692750,0,Solidly Democrat/Liberal,2016
Freedom Project,John Boehner (R-Ohio),671829,0,671829,Solidly Republican/Conservative,2016
BRIDGE PAC,James E. Clyburn (D-SC),657500,657500,0,Solidly Democrat/Liberal,2016
Making America Prosperous,Kevin Brady (R-Texas),595304,0,595304,Solidly Republican/Conservative,2016
"Jobs, Opportunities & Education PAC",Joseph Crowley (D-NY),582900,582900,0,Solidly Democrat/Liberal,2016
New Pioneers PAC,Greg Walden (R-Ore),565900,0,565900,Solidly Republican/Conservative,2016
CMR PAC,Cathy McMorris Rodgers (R-Wash),544799,0,544799,Solidly Republican/Conservative,2016
Pioneer PAC,Patrick J. Tiberi (R-Ohio),536042,0,536042,Solidly Republican/Conservative,2016
"Jobs, Economy & Budget Fund",Jeb Hensarling (R-Texas),525000,0,525000,Solidly Republican/Conservative,2016
PAC to the Future,Nancy Pelosi (D-Calif),506000,506000,0,Solidly Democrat/Liberal,2016
Leadership of Today & Tomorrow,Xavier Becerra (D-Calif),411000,411000,0,Solidly Democrat/Liberal,2016
Bluegrass Cmte,Mitch McConnell (R-Ky),378500,0,378500,Solidly Republican/Conservative,2016
Support to Ensure Victory Everywhere PAC,Steve Stivers (R-Ohio),378500,2000,376500,Solidly Republican/Conservative,2016
Next Century Fund,Richard Burr (R-NC),353000,0,353000,Solidly Republican/Conservative,2016
Voice for Freedom,Tom Price (R-Ga),350500,0,350500,Solidly Republican/Conservative,2016
Impact (Schumer),Charles E. Schumer (D-NY),345500,345500,0,Solidly Democrat/Liberal,2016
Midwest Values PAC,Al Franken (D-Minn),339500,339500,0,Solidly Democrat/Liberal,2016
Rely on Your Beliefs,Roy Blunt (R-Mo),322500,0,322500,Solidly Republican/Conservative,2016
Democrats Win Seats PAC,Debbie Wasserman Schultz (D-Fla),316500,316500,0,Solidly Democrat/Liberal,2016
Promoting Our Republican Team PAC,Rob Portman (R-Ohio),315900,0,315900,Solidly Republican/Conservative,2016
COLE PAC,Tom Cole (R-Okla),307500,0,307500,Solidly Republican/Conservative,2016
John S Fund,John M. Shimkus (R-Ill),307000,0,307000,Solidly Republican/Conservative,2016
America Works PAC,Sherrod Brown (D-Ohio),306500,306500,0,Solidly Democrat/Liberal,2016
Great Lakes PAC,Debbie Stabenow (D-Mich),305000,305000,0,Solidly Democrat/Liberal,2016
Turquoise PAC,Ben R. Lujan (D-NM),291780,291780,0,Solidly Democrat/Liberal,2016
Project West PAC,Cory Gardner (R-Colo),290826,0,290826,Solidly Republican/Conservative,2016
Shore PAC,Frank Pallone Jr (D-NJ),283000,283000,0,Solidly Democrat/Liberal,2016
House Conservatives Fund,Roger Williams (R-Texas),274000,0,274000,Solidly Republican/Conservative,2016
House Freedom Fund,Mark R. Meadows (R-NC),272350,0,272350,Solidly Republican/Conservative,2016
Kelly PAC,Kelly Ayotte (R-NH),265200,2700,262500,Solidly Republican/Conservative,2016
Citizens for Prosperity in America Today,Pat Toomey (R-Pa),263126,0,263126,Solidly Republican/Conservative,2016
TRUST PAC,Fred Upton (R-Mich),263000,0,263000,Solidly Republican/Conservative,2016
Democrats Reshaping America,Linda Sanchez (D-Calif),259000,259000,0,Solidly Democrat/Liberal,2016
New PAC,Devin Nunes (R-Calif),258000,0,258000,Solidly Republican/Conservative,2016
OrrinPAC,Orrin G. Hatch (R-Utah),255000,0,255000,Solidly Republican/Conservative,2016
ROSKAM PAC,Peter Roskam (R-Ill),254500,0,254500,Solidly Republican/Conservative,2016
Jobs & Innovation Matter PAC,Jim Himes (D-Conn),245700,245700,0,Solidly Democrat/Liberal,2016
Prairie PAC,Dick Durbin (D-Ill),237500,237500,0,Solidly Democrat/Liberal,2016
Full House PAC,Joe Heck (R-Nev),240800,0,240800,Solidly Republican/Conservative,2016
Dakota Prairie PAC,Heidi Heitkamp (D-ND),239000,239000,0,Solidly Democrat/Liberal,2016
Right To Rise PAC,ex-Gov. Jeb Bush (R-Fla),238400,0,238400,Solidly Republican/Conservative,2016
Invest in a Strong & Secure America,Darrell Issa (R-Calif),234000,0,234000,Solidly Republican/Conservative,2016
Committee for a Livable Future,Earl Blumenauer (D-Ore),233850,233850,0,Solidly Democrat/Liberal,2016
Blue Hen PAC,Chris Coons (D-Del),229500,229500,0,Solidly Democrat/Liberal,2016
Fund for a Conservative Future,James M. Inhofe (R-Okla),230000,0,230000,Solidly Republican/Conservative,2016
Rock City PAC,Bob Corker (R-Tenn),225000,0,225000,Solidly Republican/Conservative,2016
PAC for a Level Playing Field,Elizabeth Warren (D-Mass),225000,225000,0,Solidly Democrat/Liberal,2016
Country First PAC,John McCain (R-Ariz),222500,0,222500,Solidly Republican/Conservative,2016
Dirigo PAC,Susan Collins (R-Maine),221500,0,221500,Solidly Republican/Conservative,2016
CONA PAC,Mike Conaway (R-Texas),217000,0,217000,Solidly Republican/Conservative,2016
Jeff PAC,Jeff Denham (R-Calif),216941,0,216941,Solidly Republican/Conservative,2016
Nutmeg PAC,Richard Blumenthal (D-Conn),216000,216000,0,Solidly Democrat/Liberal,2016
Common Ground PAC,Tim Kaine (D-Va),215200,215200,0,Solidly Democrat/Liberal,2016
HellerHighWater PAC,Dean Heller (R-Nev),212000,0,212000,Solidly Republican/Conservative,2016
21st Century Majority Fund,Johnny Isakson (R-GA),210500,0,210500,Solidly Republican/Conservative,2016
Strategy PAC,Ron Johnson (R-Wis),210000,0,210000,Solidly Republican/Conservative,2016
Common Values PAC,John A. Barrasso (R-Wyo),208500,0,208500,Solidly Republican/Conservative,2016
Nebraska Sandhills PAC,Deb Fischer (R-Neb),205000,0,205000,Solidly Republican/Conservative,2016
Keystone America PAC,Bob Casey (D-Pa),203500,203500,0,Solidly Democrat/Liberal,2016
Searchlight Leadership Fund,Harry Reid (D-Nev),201500,201500,0,Solidly Democrat/Liberal,2016
Help America's Leaders,Hal Rogers (R-Ky),201000,0,201000,Solidly Republican/Conservative,2016
Lobo PAC,Martin Heinrich (D-NM),201000,201000,0,Solidly Democrat/Liberal,2016
Fearless PAC,Jared Polis (D-Colo),199750,199750,0,Solidly Democrat/Liberal,2016
Treasure State PAC,Jon Tester (D-Mont),199000,199000,0,Solidly Democrat/Liberal,2016
Forward Together PAC,Mark Warner (D-Va),197500,197500,0,Solidly Democrat/Liberal,2016
Freedom Fund,Mike Crapo (R-Idaho),196000,0,196000,Solidly Republican/Conservative,2016
Hoosiers First PAC,Joe Donnelly (D-Ind),194000,192000,2000,Solidly Democrat/Liberal,2016
Hawkeye PAC,Chuck Grassley (R-Iowa),193000,0,193000,Solidly Republican/Conservative,2016
Denali Leadership PAC,Lisa Murkowski (R-Alaska),191788,0,191788,Solidly Republican/Conservative,2016
Victory Now PAC,Chris Van Hollen (D-Md),191500,191500,0,Solidly Democrat/Liberal,2016
GOALPAC,Sander Levin (D-Mich),191000,191000,0,Solidly Democrat/Liberal,2016
Motor City PAC,Gary Peters (D-Mich),191000,191000,0,Solidly Democrat/Liberal,2016
ICE PAC,Erik Paulsen (R-Minn),190300,0,190300,Solidly Republican/Conservative,2016
Lank PAC,James Lankford (R-Okla),190000,0,190000,Solidly Republican/Conservative,2016
Heartland Values PAC,John Thune (R-SD),190000,0,190000,Solidly Republican/Conservative,2016
Purpose PAC,Cory Booker (D-NJ),188500,188500,0,Solidly Democrat/Liberal,2016
Follow the North Star Fund,Amy Klobuchar (D-Minn),187500,187500,0,Solidly Democrat/Liberal,2016
Defend America PAC,Richard C. Shelby (R-Ala),185000,0,185000,Solidly Republican/Conservative,2016
Peter Norbeck Leadership PAC,Mike Rounds (R-SD),183500,0,183500,Solidly Republican/Conservative,2016
Empire PAC,Kirsten Gillibrand (D-NY),180000,180000,0,Solidly Democrat/Liberal,2016
Tenn PAC,Lamar Alexander (R-Tenn),177500,0,177500,Solidly Republican/Conservative,2016
Oceans PAC,Sheldon Whitehouse (D-RI),176450,176450,0,Solidly Democrat/Liberal,2016
Narragansett Bay PAC,Jack Reed (D-RI),176000,176000,0,Solidly Democrat/Liberal,2016
M-PAC,Patty Murray (D-Wash),176000,176000,0,Solidly Democrat/Liberal,2016
Responsibility & Freedom Work PAC,Roger Wicker (R-Miss),175500,0,175500,Solidly Republican/Conservative,2016
Senate Victory Fund,Thad Cochran (R-Miss),175000,0,175000,Solidly Republican/Conservative,2016
Common Sense Colorado,Michael F. Bennet (D-Colo),172000,172000,0,Solidly Democrat/Liberal,2016
Wild & Wonderful PAC,Shelley Moore Capito (R-WVa),171500,0,171500,Solidly Republican/Conservative,2016
Free State PAC,Jerry Moran (R-Kan),170500,0,170500,Solidly Republican/Conservative,2016
Bill PAC (Shuster),Bill Shuster (R-Pa),166600,750,165850,Solidly Republican/Conservative,2016
Making Investments Majority Insured PAC,Mimi Walters (R-Calif),166200,0,166200,Solidly Republican/Conservative,2016
Arkansas for Leadership,John Boozman (R-Ark),165334,0,165334,Solidly Republican/Conservative,2016
Tomorrow Is Meaningful,Tim Scott (R-SC),164500,0,164500,Solidly Republican/Conservative,2016
"Jobs, Opportunity & New Ideas PAC",Joni Ernst (R-Iowa),163999,0,163999,Solidly Republican/Conservative,2016
Jump Into Action For Conservatives To Keep Ideas,Jackie Walorski (R-Ind),163800,0,163800,Solidly Republican/Conservative,2016
Synergy PAC,John B. Larson (D-Conn),162309,157309,5000,Solidly Democrat/Liberal,2016
Lincoln PAC,Mark Kirk (R-Ill),161000,0,161000,Solidly Republican/Conservative,2016
Lone Star Leadership PAC,Michael Burgess (R-Texas),160000,0,160000,Solidly Republican/Conservative,2016
Making Business Excel PAC,Mike Enzi (R-Wyo),160000,0,160000,Solidly Republican/Conservative,2016
First State PAC,Tom Carper (D-Del),160000,160000,0,Solidly Democrat/Liberal,2016
Opportunity & Renewal PAC,Jeff Merkley (D-Ore),159500,159500,0,Solidly Democrat/Liberal,2016
Holding Onto Oregon's Priorities,Ron Wyden (D-Ore),157500,157500,0,Solidly Democrat/Liberal,2016
Stand Tall America PAC,Mac Thornberry (R-Texas),155142,0,155142,Solidly Republican/Conservative,2016
Alamo PAC,John Cornyn (R-Texas),155000,0,155000,Solidly Republican/Conservative,2016
PETE PAC,Pete Sessions (R-Texas),153791,0,153791,Solidly Republican/Conservative,2016
People's Voice PAC,Tammy Baldwin (D-Wis),150000,150000,0,Solidly Democrat/Liberal,2016
Senate Majority Fund,ex-Sen. Jon L. Kyl (R-Ariz),148800,0,148800,Solidly Republican/Conservative,2016
Badger PAC,Ron Kind (D-Wis),147500,147500,0,Solidly Democrat/Liberal,2016
Green Mountain PAC,Patrick Leahy (D-Vt),147500,147500,0,Solidly Democrat/Liberal,2016
Road to Freedom PAC,Ed Royce (R-Calif),145500,0,145500,Solidly Republican/Conservative,2016
Liberty & Prosperity PAC,Rodney Frelinghuysen (R-NJ),145200,0,145200,Solidly Republican/Conservative,2016
Building Leadership & Inspiring New Enterprise,Blaine Luetkemeyer (R-Mo),144500,0,144500,Solidly Republican/Conservative,2016
Missourians for Accountability & Change,Claire McCaskill (D-Mo),143500,143500,0,Solidly Democrat/Liberal,2016
Reclaim America PAC,Marco Rubio (R-Fla),140000,0,140000,Solidly Republican/Conservative,2016
Continuing America's Strength & Security,Bill Cassidy (R-La),139632,0,139632,Solidly Republican/Conservative,2016
Moving America Forward,Bill Nelson (D-Fla),136500,136500,0,Solidly Democrat/Liberal,2016
Rod PAC,Rodney Davis (R-Ill),135500,1000,134500,Solidly Republican/Conservative,2016
Big Sky Opportunity PAC,Steven Daines (R-Mont),133700,0,133700,Solidly Republican/Conservative,2016
Progressive Choices PAC,Jan Schakowsky (D-Ill),133614,133614,0,Solidly Democrat/Liberal,2016
New York Jobs PAC,Steve Israel (D-NY),127938,127938,0,Solidly Democrat/Liberal,2016
Preserving America's Traditions,Pat Roberts (R-Kan),127500,0,127500,Solidly Republican/Conservative,2016
MURPHPAC,Christopher S Murphy (D-Conn),127000,127000,0,Solidly Democrat/Liberal,2016
Victory in November Election PAC,Mike Thompson (D-Calif),125970,125970,0,Solidly Democrat/Liberal,2016
Victory & Freedom PAC,Virginia Foxx (R-NC),124000,0,124000,Solidly Republican/Conservative,2016
True North PAC,Dan Sullivan (R-Alaska),122700,0,122700,Solidly Republican/Conservative,2016
Fund for America's Future,Lindsey Graham (R-SC),122000,0,122000,Solidly Republican/Conservative,2016
Southwest Leadership Fund,Tom Udall (D-NM),122000,122000,0,Solidly Democrat/Liberal,2016
What a Country! PAC,Carlos Curbelo (R-Fla),121600,1000,120600,Solidly Republican/Conservative,2016
Hawaii PAC,Brian Schatz (D-Hawaii),119300,119300,0,Solidly Democrat/Liberal,2016
Lead Encourage Elect PAC,Mike Lee (R-Utah),118000,0,118000,Solidly Republican/Conservative,2016
PAC for a Change,Barbara Boxer (D-Calif),117500,117500,0,Solidly Democrat/Liberal,2016
Committee for the Preservation of Capitalism,Charles W Boustany Jr (R-La),116670,0,116670,Solidly Republican/Conservative,2016
Common Sense Common Solutions,Kay Granger (R-Texas),116500,0,116500,Solidly Republican/Conservative,2016
A New Direction PAC,Jeanne Shaheen (D-NH),116500,116500,0,Solidly Democrat/Liberal,2016
Guardian Fund,Barry Loudermilk (R-Ga),110000,0,110000,Solidly Republican/Conservative,2016
LOIS PAC,Lois J Frankel (D-Fla),109710,109710,0,Solidly Democrat/Liberal,2016
Jet PAC,Adam Kinzinger (R-Ill),109216,0,109216,Solidly Republican/Conservative,2016
4MA Pac,Joe Kennedy III (D-Mass),107500,107500,0,Solidly Democrat/Liberal,2016
First In Freedom Pac,Richard Hudson (R-NC),105700,0,105700,Solidly Republican/Conservative,2016
Liberty Project,Randy Neugebauer (R-Texas),102500,0,102500,Solidly Republican/Conservative,2016
LEGPAC,Ben Cardin (D-Md),102500,102500,0,Solidly Democrat/Liberal,2016
Dakota PAC,John Hoeven (R-ND),100000,0,100000,Solidly Republican/Conservative,2016
Save America PAC,James E Risch (R-Idaho),100000,0,100000,Solidly Republican/Conservative,2016
Texas Republicans United PAC,Michael McCaul (R-Texas),100000,0,100000,Solidly Republican/Conservative,2016
YoPAC,Kevin Yoder (R-Kan),99500,0,99500,Solidly Republican/Conservative,2016
Ocean State PAC,Jim Langevin (D-RI),99000,99000,0,Solidly Democrat/Liberal,2016
Good Fund,Bob Goodlatte (R-VA),97852,0,97852,Solidly Republican/Conservative,2016
CherPAC,Cheri Bustos (D-Ill),96608,96608,0,Solidly Democrat/Liberal,2016
Bill PAC (Flores),Bill Flores (R-Texas),96500,0,96500,Solidly Republican/Conservative,2016
Tallatchee Creek Inc,Jeff Sessions (R-Ala),96500,0,96500,Solidly Republican/Conservative,2016
PEM PAC,Patrick E. Murphy (D-Fla),95400,95400,0,Solidly Democrat/Liberal,2016
Eureka PAC,Ken Calvert (R-Calif),94500,0,94500,Solidly Republican/Conservative,2016
Blue Majority PAC,Mark Pocan (D-Wis),94093,94093,0,Solidly Democrat/Liberal,2016
Fund for the Majority,Dianne Feinstein (D-Calif),92500,92500,0,Solidly Democrat/Liberal,2016
Supporting United States of America's Next Leaders,Susan Brooks (R-Ind),92336,0,92336,Solidly Republican/Conservative,2016
Fiscal Leadership & Knowing Economics,Jeff Flake (R-Ariz),91500,0,91500,Solidly Republican/Conservative,2016
Republican Majority Fund,Tom Cotton (R-Ark),91157,0,91157,Solidly Republican/Conservative,2016
Leadership Matters for America,Gov. Chris Christie (R-NJ),91000,0,91000,Solidly Republican/Conservative,2016
Patriots Leading a Majority,Patrick Meehan (R-Pa),90500,0,90500,Solidly Republican/Conservative,2016
Freedom & Security PAC,John Kline (R-Minn),89720,0,89720,Solidly Republican/Conservative,2016
Conservative Promises PAC,Gary Palmer (R-Ala),88200,0,88200,Solidly Republican/Conservative,2016
Mainstream PAC,Zoe Lofgren (D-Calif),87500,87500,0,Solidly Democrat/Liberal,2016
DIANE PAC,Diane Black (R-Tenn),86000,0,86000,Solidly Republican/Conservative,2016
Eagle PAC,Bob Dold (R-Ill),85099,0,85099,Solidly Republican/Conservative,2016
Defense Economic Renewal Education & Knowledge PAC,Derek Kilmer (D-Wash),82100,82100,0,Solidly Democrat/Liberal,2016
Article 1 PAC,John A. Yarmuth (D-Ky),82500,82500,0,Solidly Democrat/Liberal,2016
Together Holding Our Majority PAC,Thom Tillis (R-NC),80000,0,80000,Solidly Republican/Conservative,2016
Gene PAC,Gene Green (D-Texas),78500,78500,0,Solidly Democrat/Liberal,2016
HECK PAC,Dennis Heck (D-Wash),78400,78400,0,Solidly Democrat/Liberal,2016
Oorah! PAC,Todd Young (R-Ind),78004,0,78004,Solidly Republican/Conservative,2016
EDPAC,Edwin G Perlmutter (D-Colo),78000,78000,0,Solidly Democrat/Liberal,2016
SarahPAC,ex-Gov. Sarah Palin (R-Alaska),77500,0,77500,Solidly Republican/Conservative,2016
Lead Your Nation Now PAC,Lynn Jenkins (R-Kan),77500,0,77500,Solidly Republican/Conservative,2016
Michigan's Future PAC,Dan Kildee (D-Mich),76000,76000,0,Solidly Democrat/Liberal,2016
Sensible American Solutions Supporting Everyone,Ben Sasse (R-Neb),75700,0,75700,Solidly Republican/Conservative,2016
Clean PAC,Jared Huffman (D-Calif),75609,75609,0,Solidly Democrat/Liberal,2016
IRL PAC,Ileana Ros-Lehtinen (R-Fla),75500,0,75500,Solidly Republican/Conservative,2016
The US Campaign Fund,John Sarbanes (D-Md),74919,74919,0,Solidly Democrat/Liberal,2016
Building America's Republican Representation,Andy Barr (R-Ky),73500,0,73500,Solidly Republican/Conservative,2016
Serve America PAC,Seth Moulton (D-Mass),73075,73075,0,Solidly Democrat/Liberal,2016
American Security PAC,Mike D. Rogers (R-Ala),72000,0,72000,Solidly Republican/Conservative,2016
Excelsior PAC,Tom Reed (R-NY),71606,0,71606,Solidly Republican/Conservative,2016
Ann PAC,Ann L. Wagner (R-Mo),71000,0,71000,Solidly Republican/Conservative,2016
BackPAC,Don Beyer (D-Va),69900,69900,0,Solidly Democrat/Liberal,2016
New Mexico Works PAC,Michelle Lujan Grisham (D-NM),69500,69500,0,Solidly Democrat/Liberal,2016
One Georgia PAC,David Perdue (R-Ga),68700,0,68700,Solidly Republican/Conservative,2016
Re-Light America PAC,Keith J Rothfus (R-Pa),67500,0,67500,Solidly Republican/Conservative,2016
Middle Class America PAC,Daniel Lipinski (D-Ill),67500,62500,5000,Solidly Democrat/Liberal,2016
Three Rivers PAC,Kurt Schrader (D-Ore),67500,67500,0,Solidly Democrat/Liberal,2016
Lee PAC,Lee Zeldin (R-NY),66900,0,66900,Solidly Republican/Conservative,2016
LLEGO-PAC,Ruben Gallego (D-Ariz),66500,66500,0,Solidly Democrat/Liberal,2016
Committee for Leadership & Progress,Nita M. Lowey (D-NY),64000,64000,0,Solidly Democrat/Liberal,2016
First Principles Fund,Ron DeSantis (R-Fla),63500,0,63500,Solidly Republican/Conservative,2016
Impact Cmte,Michael R. Turner (R-Ohio),61835,0,61835,Solidly Republican/Conservative,2016
RACPAC,Ryan Costello (R-Pa),61700,0,61700,Solidly Republican/Conservative,2016
Longhorn PAC,Lamar Smith (R-Texas),61200,0,61200,Solidly Republican/Conservative,2016
GWEN PAC,Gwen Moore (D-Wis),61200,61200,0,Solidly Democrat/Liberal,2016
Renewing the American Dream PAC,Tim Walz (D-Minn),61100,61100,0,Solidly Democrat/Liberal,2016
"Leadership, Integrity, Engagement, Unity Pac",Ted Lieu (D-Calif),61000,61000,0,Solidly Democrat/Liberal,2016
All America PAC,ex-Sen. Evan Bayh (D-Ind),60500,60500,0,Solidly Democrat/Liberal,2016
Vision for America PAC,Jackie Speier (D-Calif),60099,60099,0,Solidly Democrat/Liberal,2016
Supporting Electing American Leaders,Ryan K Zinke (R-Mont),59200,2000,57200,Solidly Republican/Conservative,2016
Maple PAC,Peter Welch (D-VT),58500,58500,0,Solidly Democrat/Liberal,2016
SAC PAC,Doris O Matsui (D-Calif),58500,58500,0,Solidly Democrat/Liberal,2016
Peace Through Strength Pac,Duncan D Hunter (R-Calif),58100,0,58100,Solidly Republican/Conservative,2016
Secure PAC,Bennie G. Thompson (D-Miss),58000,58000,0,Solidly Democrat/Liberal,2016
"Jobs, Freedom & Security PAC",Ted Cruz (R-Texas),57993,0,57993,Solidly Republican/Conservative,2016
LATTA PAC,Robert E. Latta (R-Ohio),57500,0,57500,Solidly Republican/Conservative,2016
New Republican Majority Fund,ex-Sen. Trent Lott (R-Miss),57000,0,57000,Solidly Republican/Conservative,2016
DENT PAC,Charlie Dent (R-Pa),56000,0,56000,Solidly Republican/Conservative,2016
Truth Is Markets Work Fund,Tim Walberg (R-Mich),56000,0,56000,Solidly Republican/Conservative,2016
CASTLEPAC,ex-Rep. Michael Castle (R-Del),54887,0,54887,Solidly Republican/Conservative,2016
Reasonable Independent Constructive & Effective,Kathleen Rice (D-NY),54100,54100,0,Solidly Democrat/Liberal,2016
Greater Tomorrow PAC,Glenn Thompson (R-Pa),53600,0,53600,Solidly Republican/Conservative,2016
Nova PAC,Barbara Comstock (R-Va),53300,0,53300,Solidly Republican/Conservative,2016
Fostering Progress PAC,Bill Foster (D-Ill),53100,53100,0,Solidly Democrat/Liberal,2016
One Voice,Barbara Lee (D-Calif),53000,53000,0,Solidly Democrat/Liberal,2016
Puget PAC,Rick Larsen (D-Wash),52200,52200,0,Solidly Democrat/Liberal,2016
Supporting House Problem Solvers,Scott Peters (D-Calif),51700,51700,0,Solidly Democrat/Liberal,2016
Maintaining All Republicans in Office,Mario Diaz-Balart (R-Fla),51230,0,51230,Solidly Republican/Conservative,2016
Progressive Americans for Democracy,Peter DeFazio (D-Ore),51100,51100,0,Solidly Democrat/Liberal,2016
Wells PAC,Austin Scott (R-GA),50766,0,50766,Solidly Republican/Conservative,2016
Peninsula PAC,Anna Eshoo (D-Calif),50354,50354,0,Solidly Democrat/Liberal,2016
Fair Shot PAC,Katherine Clark (D-Mass),50000,50000,0,Solidly Democrat/Liberal,2016
Brave PAC,David Scott (D-Ga),50000,49000,1000,Solidly Democrat/Liberal,2016
Victory by Investing Building & Empowering PAC,Tony Cardenas (D-Calif),49600,49600,0,Solidly Democrat/Liberal,2016
ANDER PAC,Ander Crenshaw (R-Fla),49500,0,49500,Solidly Republican/Conservative,2016
Mr Southern Missourian in the House,Jason Smith (R-Mo),48907,0,48907,Solidly Republican/Conservative,2016
Roll On Columbia,ex-Rep. Doc Hastings (R-Wash),48100,0,48100,Solidly Republican/Conservative,2016
Boots PAC,Markwayne Mullin (R-Okla),47400,0,47400,Solidly Republican/Conservative,2016
Having Unwavering Resolve & Determination,Will Hurd (R-Texas),47300,0,47300,Solidly Republican/Conservative,2016
Keeping America Rolling PAC,Mike Kelly (R-PA),46950,0,46950,Solidly Republican/Conservative,2016
Ax PAC,Sean P. Duffy (R-Wis),45750,0,45750,Solidly Republican/Conservative,2016
Inland Empire Strikes PAC,Mark A Takano (D-Calif),46650,46650,0,Solidly Democrat/Liberal,2016
CARTER PAC,John Carter (R-Texas),46500,0,46500,Solidly Republican/Conservative,2016
Thunderbolt PAC,Martha McSally (R-Ariz),45900,0,45900,Solidly Republican/Conservative,2016
American Defense & Military PAC,Adam Smith (D-Wash),45700,45700,0,Solidly Democrat/Liberal,2016
Del PAC,John Carney (D-Del),44800,44800,0,Solidly Democrat/Liberal,2016
Building A Majority PAC,Barbara A. Mikulski (D-Md),44000,27500,16500,Leans Democrat/Liberal,2016
Pineapple PAC,Mazie K Hirono (D-Hawaii),43726,43726,0,Solidly Democrat/Liberal,2016
Fund for American Opportunity,ex-Sen. Spencer Abraham (R-Mich),43500,0,43500,Solidly Republican/Conservative,2016
Silk PAC,Bill Pascrell Jr (D-NJ),43000,43000,0,Solidly Democrat/Liberal,2016
Building Renewal in America Now,Brian Babin (R-Texas),43000,0,43000,Solidly Republican/Conservative,2016
DR RAUL PAC,Raul Ruiz (D-Calif),42900,42900,0,Solidly Democrat/Liberal,2016
Vaquero PAC,Filemon Vela (D-Texas),42600,42600,0,Solidly Democrat/Liberal,2016
FROG Jump PAC,Steve Fincher (R-Tenn),42600,0,42600,Solidly Republican/Conservative,2016
SCOTT PAC,Scott Garrett (R-NJ),42278,0,42278,Solidly Republican/Conservative,2016
GreggPAC,Gregg Harper (R-Miss),42000,0,42000,Solidly Republican/Conservative,2016
Georgia PAC,Tom Graves (R-Ga),42000,0,42000,Solidly Republican/Conservative,2016
Show Me PAC,Sam Graves (R-MO),42000,0,42000,Solidly Republican/Conservative,2016
Vitoria PAC,David Valadao (R-Calif),42000,0,42000,Solidly Republican/Conservative,2016
Electing Majority Making Effective Republicans,Tom Emmer (R-Minn),41500,0,41500,Solidly Republican/Conservative,2016
Keystone Fund,Mike Doyle (D-Pa),41500,41500,0,Solidly Democrat/Liberal,2016
MARSHA PAC,Marsha Blackburn (R-Tenn),40500,0,40500,Solidly Republican/Conservative,2016
Dutch PAC,Dutch Ruppersberger (D-Md),40000,40000,0,Solidly Democrat/Liberal,2016
House Liberty Fund,Jim Jordan (R-Ohio),40000,0,40000,Solidly Republican/Conservative,2016
Defending America's Values Everywhere,David Schweikert (R-Ariz),40000,0,40000,Solidly Republican/Conservative,2016
HeartDocPAC,Larry Bucshon (R-Ind),39200,0,39200,Solidly Republican/Conservative,2016
E-PAC,Elise Stefanik (R-NY),38500,0,38500,Solidly Republican/Conservative,2016
Climate Champions PAC,Jeff Merkley (D-Ore),37500,37500,0,Solidly Democrat/Liberal,2016
Buckeye Patriot PAC,ex-Rep. David Hobson (R-Ohio),37080,0,37080,Solidly Republican/Conservative,2016
Individuals Dedicated to Ethics & Science,Diana DeGette (D-Colo),37000,37000,0,Solidly Democrat/Liberal,2016
Martha PAC,Martha Roby (R-Ala),37000,0,37000,Solidly Republican/Conservative,2016
Husky PAC,Joe Courtney (D-Conn),36100,36100,0,Solidly Democrat/Liberal,2016
Commonwealth PAC (Connolly),Gerry Connolly (D-Va),35200,35200,0,Solidly Democrat/Liberal,2016
BYRNE PAC,Bradley Byrne (R-Ala),35000,0,35000,Solidly Republican/Conservative,2016
Deciding Critical Races,David Rouzer (R-NC),34800,0,34800,Solidly Republican/Conservative,2016
Reinventing a New Direction,Rand Paul (R-Ky),34500,0,34500,Solidly Republican/Conservative,2016
Come Back PAC,Tim Murphy (R-Pa),34400,0,34400,Solidly Republican/Conservative,2016
Keeping Republican Ideas Strong Timely,Kristi Noem (R-SD),34200,0,34200,Solidly Republican/Conservative,2016
Reaching for a Brighter America PAC,Robert B. Aderholt (R-Ala),34000,0,34000,Solidly Republican/Conservative,2016
O'Say Can You See PAC,ex-Gov. Martin O'Malley (D-MD),33950,33950,0,Solidly Democrat/Liberal,2016
GOLD PAC,Sanford Bishop Jr (D-Ga),33700,33700,0,Solidly Democrat/Liberal,2016
Country Roads PAC,Joe Manchin (D-WVa),33500,33500,0,Solidly Democrat/Liberal,2016
Rural America Counts PAC,Rick Crawford (R-Ark),33500,0,33500,Solidly Republican/Conservative,2016
Promise Pac,Marcia L. Fudge (D-Ohio),33200,33200,0,Solidly Democrat/Liberal,2016
Louisiana Values PAC,John Fleming (R-La),33000,0,33000,Solidly Republican/Conservative,2016
At the Table!,Grace Meng (D-NY),32700,32700,0,Solidly Democrat/Liberal,2016
Olympia's List,ex-Sen. Olympia Snowe (R-Maine),32500,0,32500,Solidly Republican/Conservative,2016
Betty PAC,Betty McCollum (D-Minn),32000,32000,0,Solidly Democrat/Liberal,2016
Making a Real Change,Marc Veasey (D-Texas),31100,31100,0,Solidly Democrat/Liberal,2016
Getting Stuff Done PAC,Kyrsten Sinema (D-Ariz),30700,30700,0,Solidly Democrat/Liberal,2016
Educate & Innovate PAC,Ed Markey (D-Mass),30100,30100,0,Solidly Democrat/Liberal,2016
Badlands PAC,Kevin Cramer (R-ND),30000,0,30000,Solidly Republican/Conservative,2016
Democrats Time In Nevada,Dina Titus (D-Nev),29626,29626,0,Solidly Democrat/Liberal,2016
Madison PAC (Neal),Richard E. Neal (D-Mass),29500,29500,0,Solidly Democrat/Liberal,2016
Immigration Reform Fund,Luis V Gutierrez (D-Ill),28700,28700,0,Solidly Democrat/Liberal,2016
Wolverine PAC,Debbie Dingell (D-Mich),28500,28500,0,Solidly Democrat/Liberal,2016
Marlin PAC,Marlin Stutzman (R-Ind),28500,0,28500,Solidly Republican/Conservative,2016
TERRI PAC,Terri A Sewell (D-Ala),28200,28200,0,Solidly Democrat/Liberal,2016
USA First PAC,Ben Carson (R-),28000,0,28000,Solidly Republican/Conservative,2016
Acton PAC,Lynn A. Westmoreland (R-Ga),28000,0,28000,Solidly Republican/Conservative,2016
Every Republican is Crucial PAC,ex-Rep. Eric Cantor (R-Va),27500,0,27500,Solidly Republican/Conservative,2016
Seagrass PAC,David Jolly (R-Fla),27200,0,27200,Solidly Republican/Conservative,2016
Progressives Advancing United Leadership,Paul Tonko (D-NY),27000,27000,0,Solidly Democrat/Liberal,2016
DNC PAC,David Cicilline (D-RI),26930,26930,0,Solidly Democrat/Liberal,2016
VICKY PAC,Vicky Hartzler (R-Mo),26329,0,26329,Solidly Republican/Conservative,2016
Hudson Valley PAC (Maloney),Sean Patrick Maloney (D-NY),26100,26100,0,Solidly Democrat/Liberal,2016
Valley PAC,Collin C. Peterson (D-Minn),26000,26000,0,Solidly Democrat/Liberal,2016
Vote to Elect Republicans Now PAC,Vernon Buchanan (R-Fla),25900,0,25900,Solidly Republican/Conservative,2016
Make It Work,Angus King (I-Maine),25500,21500,4000,Leans Democrat/Liberal,2016
Thoroughbred PAC,Ed Whitfield (R-Ky),25092,0,25092,Solidly Republican/Conservative,2016
New Energy PAC,Eric Swalwell (D-Calif),25049,25049,0,Solidly Democrat/Liberal,2016
Grow Our House PAC,Louis B Gohmert Jr (R-Texas),25000,0,25000,Solidly Republican/Conservative,2016
Texas Freedom Fund,Joe Barton (R-Texas),25000,0,25000,Solidly Republican/Conservative,2016
New Vision America Fund,Mike Honda (D-Calif),24500,24500,0,Solidly Democrat/Liberal,2016
TN4U PAC,Scott Desjarlais (R-Tenn),24500,0,24500,Solidly Republican/Conservative,2016
Harvest PAC,ex-Rep. Allen Boyd (D-Fla),24250,18250,6000,Leans Democrat/Liberal,2016
Science Energy & Environment Change PAC,Jerry McNerney (D-Calif),24200,24200,0,Solidly Democrat/Liberal,2016
Free & Strong America PAC,ex-Gov. Mitt Romney (R-),24188,0,24188,Solidly Republican/Conservative,2016
Semper Fi PAC,Paul Cook (R-Calif),24100,0,24100,Solidly Republican/Conservative,2016
Time to Unite Lead & Serve with Integrity,Tulsi Gabbard (D-Hawaii),24000,24000,0,Solidly Democrat/Liberal,2016
Holding the Majority,George Holding (R-NC),24000,0,24000,Solidly Republican/Conservative,2016
Believe in Life Liberty Yourself,Billy Long (R-Mo),24000,0,24000,Solidly Republican/Conservative,2016
CA-LUV PAC,Pete Aguilar (D-Calif),23900,23900,0,Solidly Democrat/Liberal,2016
Leadership that Listens PAC,Donna Edwards (D-Md),23775,23775,0,Solidly Democrat/Liberal,2016
Doing Our Utmost For God Liberty & Security,Douglas L. Lamborn (R-Colo),23500,0,23500,Solidly Republican/Conservative,2016
Who Dat PAC,Cedric Richmond (D-La),23500,23500,0,Solidly Democrat/Liberal,2016
American Innovation PAC,Ami Bera (D-Calif),23200,23200,0,Solidly Democrat/Liberal,2016
Funding Developing Leadership PAC,Frank D. Lucas (R-Okla),23000,0,23000,Solidly Republican/Conservative,2016
Future Leaders PAC,ex-Rep. Jerry Lewis (R-Calif),23000,0,23000,Solidly Republican/Conservative,2016
First Team PAC,Tom Rooney (R-Fla),22899,0,22899,Solidly Republican/Conservative,2016
America Now,Andre Carson (D-Ind),22700,22700,0,Solidly Democrat/Liberal,2016
Build America PAC,Gregory W. Meeks (D-NY),22500,22500,0,Solidly Democrat/Liberal,2016
Free Markets PAC,Robert Pittenger (R-NC),22250,0,22250,Solidly Republican/Conservative,2016
Effective Leadership Enhancing Communities Today,Elizabeth Esty (D-Conn),22000,22000,0,Solidly Democrat/Liberal,2016
Razor PAC,Steve Womack (R-Ark),22000,0,22000,Solidly Republican/Conservative,2016
Salt City PAC,John Katko (R-NY),21700,0,21700,Solidly Republican/Conservative,2016
Relentless Positive Action PAC,Gov. Rick Snyder (R-Mich),21600,0,21600,Solidly Republican/Conservative,2016
We Ignite New Energy PAC,Justin Fareed (R-Calif),21400,0,21400,Solidly Republican/Conservative,2016
Freedom Matters PAC,Pete Olson (R-Texas),21398,0,21398,Solidly Republican/Conservative,2016
Hold the Center PAC,ex-Sen. Mary L. Landrieu (D-La),21000,21000,0,Solidly Democrat/Liberal,2016
Titletown PAC,Reid Ribble (R-Wis),20900,0,20900,Solidly Republican/Conservative,2016
Constitutional Conservatives Fund,Mike Lee (R-Utah),20000,0,20000,Solidly Republican/Conservative,2016
Bulldog Victory PAC,David Young (R-Iowa),20000,0,20000,Solidly Republican/Conservative,2016
Southern California Fund,Brad Sherman (D-Calif),20000,20000,0,Solidly Democrat/Liberal,2016
Pine Tree PAC,Bruce Poliquin (R-Maine),19700,0,19700,Solidly Republican/Conservative,2016
Help Unite Republicans Today PAC,Robert Hurt (R-Va),19500,0,19500,Solidly Republican/Conservative,2016
Midnight Sun,Don Young (R-Alaska),19000,0,19000,Solidly Republican/Conservative,2016
Louisiana Reform PAC,David Vitter (R-LA),18500,0,18500,Solidly Republican/Conservative,2016
Priority PAC,ex-Sen. Mark Pryor (D-Ark),18500,18500,0,Solidly Democrat/Liberal,2016
Sea Change Leadership PAC,Karen Bass (D-Calif),18500,18500,0,Solidly Democrat/Liberal,2016
Reform Washington Leadership PAC,Lt Gov Carlos Lopez-Cantera (R-Fla),18300,0,18300,Solidly Republican/Conservative,2016
JustinPAC,Justin Amash (R-Mich),18200,0,18200,Solidly Republican/Conservative,2016
Land Of Opportunity PAC,Bruce Westerman (R-Ark),18000,0,18000,Solidly Republican/Conservative,2016
Peach PAC,Doug Collins (R-GA),18000,0,18000,Solidly Republican/Conservative,2016
BRETTPAC,Brett Guthrie (R-Ky),18000,0,18000,Solidly Republican/Conservative,2016
New Voice PAC,Joyce Beatty (D-Ohio),17500,17500,0,Solidly Democrat/Liberal,2016
Make It In America PAC,John Garamendi (D-Calif),17500,17500,0,Solidly Democrat/Liberal,2016
Conservatives Restoring Excellence,Renee Ellmers (R-NC),17200,0,17200,Solidly Republican/Conservative,2016
CavPAC,Mike Pompeo (R-Kan),17089,0,17089,Solidly Republican/Conservative,2016
Battleground PAC,Mark Walker (R-NC),17000,0,17000,Solidly Republican/Conservative,2016
Sawtooth PAC,Mike Simpson (R-Idaho),17000,0,17000,Solidly Republican/Conservative,2016
Texas First PAC,Henry Cuellar (D-Texas),17000,17000,0,Solidly Democrat/Liberal,2016
Belief In Life & Liberty,Bill Johnson (R-Ohio),16900,0,16900,Solidly Republican/Conservative,2016
Congressional House Republicans In Service PAC,Chris Collins (R-NY),16700,0,16700,Solidly Republican/Conservative,2016
Fund for American Exceptionalism,Todd Rokita (R-Ind),16500,0,16500,Solidly Republican/Conservative,2016
TEDPAC,Ted Deutch (D-Fla),16400,16400,0,Solidly Democrat/Liberal,2016
United for Progress Leadership Cmte,ex-Rep. Jerry F. Costello (D-Ill),16000,16000,0,Solidly Democrat/Liberal,2016
South Dakota First PAC,ex-Sen. Tim Johnson (D-SD),16000,16000,0,Solidly Democrat/Liberal,2016
"Jobs, Energy & Our Founding Fathers PAC",Jeff Duncan (R-SC),16000,0,16000,Solidly Republican/Conservative,2016
WinNovember PAC,Steve Chabot (R-Ohio),16000,0,16000,Solidly Republican/Conservative,2016
AnniePAC,Ann McLane Kuster (D-NH),16000,16000,0,Solidly Democrat/Liberal,2016
DBM PAC,David McKinley (R-WVa),16000,0,16000,Solidly Republican/Conservative,2016
Jobs Unite Labor & Industry in America,Julia Brownley (D-Calif),16000,16000,0,Solidly Democrat/Liberal,2016
Pioneer PAC (Rob Bishop),Rob Bishop (R-Utah),15500,0,15500,Solidly Republican/Conservative,2016
Carolyn's PAC,Carolyn B. Maloney (D-NY),15500,15500,0,Solidly Democrat/Liberal,2016
Ohio USA PAC,ex-Sen. George V Voinovich (R-Ohio),15500,5000,10500,Leans Republican/Conservative,2016
Mac PAC,James P McGovern (D-Mass),15356,15356,0,Solidly Democrat/Liberal,2016
Mass PAC,Michael E Capuano (D-Mass),15000,15000,0,Solidly Democrat/Liberal,2016
Continuing a Majority Party Action Cmte,ex-Rep. Dave Camp (R-Mich),15000,0,15000,Solidly Republican/Conservative,2016
Securing America's Future PAC,ex-Rep. Mike Rogers (R-Mich),15000,0,15000,Solidly Republican/Conservative,2016
Secure America's Majority PAC,Sam Johnson (R-Texas),15000,0,15000,Solidly Republican/Conservative,2016
R Senate PAC,John Cornyn (R-Texas),15000,0,15000,Solidly Republican/Conservative,2016
Perimeter PAC,Tammy Duckworth (D-Ill),15000,15000,0,Solidly Democrat/Liberal,2016
America's Future Fund PAC,Jim Renacci (R-Ohio),14600,0,14600,Solidly Republican/Conservative,2016
I-PAC,David Loebsack (D-Iowa),14500,14500,0,Solidly Democrat/Liberal,2016
MISSION PAC,Lois Capps (D-Calif),14400,14400,0,Solidly Democrat/Liberal,2016
Patriot PAC (Palazzo),Steven Palazzo (R-Miss),14200,1000,13200,Solidly Republican/Conservative,2016
Valor PAC,Brian Mast (R-Fla),14041,0,14041,Solidly Republican/Conservative,2016
Marketplace Ideas & Conserv Knowledge,Mick Mulvaney (R-SC),14000,0,14000,Solidly Republican/Conservative,2016
Leading Orange County PAC,Loretta Sanchez (D-CA),14000,14000,0,Solidly Democrat/Liberal,2016
People Helping People,Maxine Waters (D-Calif),13778,13778,0,Solidly Democrat/Liberal,2016
Giving Us Security PAC,Gus Bilirakis (R-Fla),13700,0,13700,Solidly Republican/Conservative,2016
NORM PAC,ex-Rep. Norm Dicks (D-Wash),13600,13600,0,Solidly Democrat/Liberal,2016
United for A Strong America,Adam Schiff (D-Calif),13500,13500,0,Solidly Democrat/Liberal,2016
Keystone Leadership PAC,Michael G. Fitzpatrick (R-Pa),13400,0,13400,Solidly Republican/Conservative,2016
New Opportunity for Real Monumental Action,Norma Torres (D-Calif),13184,13184,0,Solidly Democrat/Liberal,2016
Together for Our Majority,ex-Rep. Tom Reynolds (R-NY),13061,4000,9061,Leans Republican/Conservative,2016
KITPAC 2,ex-Sen. Christopher S. 'Kit' Bond (R-MO),13000,0,13000,Solidly Republican/Conservative,2016
Penguin PAC,Tim Ryan (D-Ohio),13000,13000,0,Solidly Democrat/Liberal,2016
Peak PAC,ex-Sen. Mark Udall (D-Colo),13000,13000,0,Solidly Democrat/Liberal,2016
We the People PAC,Ex-Rep. Allyson Schwartz (D-Pa),12700,12700,0,Solidly Democrat/Liberal,2016
Taxpayers Incensed By Government Excess,Dennis Ross (R-Fla),12700,0,12700,Solidly Republican/Conservative,2016
Republicans in Congress Empowering America,Tom Rice (R-SC),12700,0,12700,Solidly Republican/Conservative,2016
Citizens Strengthening Our Majority in the House,Chris Smith (R-NJ),12500,0,12500,Solidly Republican/Conservative,2016
Cool PAC,Daniel Webster (R-Fla),12400,0,12400,Solidly Republican/Conservative,2016
Defending American Values Everywhere,David P Joyce (R-Ohio),12400,0,12400,Solidly Republican/Conservative,2016
Leadership Responsibility & Action PAC,Lucille Roybal-Allard (D-Calif),12250,12250,0,Solidly Democrat/Liberal,2016
Brighter Futures PAC,Blake Farenthold (R-Tex),12000,0,12000,Solidly Republican/Conservative,2016
Jobs Education & Families First,Hakeem Jeffries (D-NY),12000,12000,0,Solidly Democrat/Liberal,2016
Buddy PAC,Buddy Carter (R-Ga),12000,0,12000,Solidly Republican/Conservative,2016
Committee for a Democratic Future,Rosa L DeLauro (D-Conn),12000,12000,0,Solidly Democrat/Liberal,2016
Cincinnatus PAC,Cincinnati Mayor John Cranley (D),11700,11700,0,Solidly Democrat/Liberal,2016
Building & Restoring the American Dream,Brad Wenstrup (R-Ohio),11200,0,11200,Solidly Republican/Conservative,2016
Building Our Base - Bob PAC,Bob Gibbs (R-Ohio),11200,0,11200,Solidly Republican/Conservative,2016
Chesapeake PAC,Andy Harris (R-Md),11111,0,11111,Solidly Republican/Conservative,2016
"NorCal Water, Jobs, Liberty",Doug LaMalfa (R-Calif),11100,0,11100,Solidly Republican/Conservative,2016
Defending America's Future,Trent Franks (R-Ariz),11000,0,11000,Solidly Republican/Conservative,2016
Long Leaf Pine PAC,ex-Sen. Kay R Hagan (D-NC),11000,11000,0,Solidly Democrat/Liberal,2016
Guts PAC,Alan Grayson (D-Fla),11000,11000,0,Solidly Democrat/Liberal,2016
LA PAC,ex-Rep. Henry Waxman (D-Calif),11000,11000,0,Solidly Democrat/Liberal,2016
Strengthening Virginia's Working Families PAC,Bobby Scott (D-Va),10400,10400,0,Solidly Democrat/Liberal,2016
Toward Tomorrow PAC,Joaquin Castro (D-Texas),10091,10091,0,Solidly Democrat/Liberal,2016
Love PAC,Mia Love (R-Utah),10030,0,10030,Solidly Republican/Conservative,2016
T-MAC PAC,Thomas MacArthur (R-NJ),10000,0,10000,Solidly Republican/Conservative,2016
TROTTER PAC,Dave Trott (R-Mich),10000,0,10000,Solidly Republican/Conservative,2016
Calumet PAC,Pete Visclosky (D-Ind),10000,10000,0,Solidly Democrat/Liberal,2016
New South Leadership PAC,G K Butterfield (D-NC),10000,10000,0,Solidly Democrat/Liberal,2016
Making a Sensible Shift in Elections,Thomas Massie (R-Ky),9700,0,9700,Solidly Republican/Conservative,2016
Making Americans Count PAC,Matt Cartwright (D-Pa),9622,9622,0,Solidly Democrat/Liberal,2016
Common Good Fund,Jim McDermott (D-Wash),9500,9500,0,Solidly Democrat/Liberal,2016
Viking Leadership PAC,Tom Emmer (R-Minn),9500,0,9500,Solidly Republican/Conservative,2016
Huck PAC,ex-Gov. Mike Huckabee (R-),9500,0,9500,Solidly Republican/Conservative,2016
Accountability PAC,Bill Posey (R-Fla),9400,0,9400,Solidly Republican/Conservative,2016
Beehive PAC,Jason Chaffetz (R-Utah),9284,0,9284,Solidly Republican/Conservative,2016
Michigan First PAC,Dan Benishek (R-Mich),9235,0,9235,Solidly Republican/Conservative,2016
Rocket PAC,ex-Rep. Rush Holt (D-NJ),9100,9100,0,Solidly Democrat/Liberal,2016
American Freedom PAC,Tim Huelskamp (R-Kan),9000,0,9000,Solidly Republican/Conservative,2016
Americans for Republican Leadership,Leonard Lance (R-NJ),9000,0,9000,Solidly Republican/Conservative,2016
SkiPAC,Ex-Rep. Jim Matheson (D-Utah),8700,8700,0,Solidly Democrat/Liberal,2016
Empowering Each Community PAC,Elijah E. Cummings (D-Md),8600,8600,0,Solidly Democrat/Liberal,2016
Sheriff PAC,Dave Reichert (R-Wash),8500,0,8500,Solidly Republican/Conservative,2016
Building Infrastructure Harnessing Our Priorities,ex-Rep. Timothy H Bishop (D-NY),8500,8500,0,Solidly Democrat/Liberal,2016
Ken PAC,Kenny Marchant (R-Texas),8500,0,8500,Solidly Republican/Conservative,2016
Taking an Independent Perspective Together Our Ntn,Scott Tipton (R-Colo),8400,0,8400,Solidly Republican/Conservative,2016
Prosper New York PAC,Richard Hanna (R-NY),8000,0,8000,Solidly Republican/Conservative,2016
Jerry Lewis PAC,ex-Rep. Jerry Lewis (R-Calif),8000,0,8000,Solidly Republican/Conservative,2016
Hoosier PAC,ex-Rep. Dan Burton (R-Ind),8000,0,8000,Solidly Republican/Conservative,2016
Buckeye Liberty PAC,Jim Jordan (R-Ohio),7500,0,7500,Solidly Republican/Conservative,2016
PUCK PAC,Mike Quigley (D-Ill),7500,7500,0,Solidly Democrat/Liberal,2016
Rebuild America PAC,Ted Yoho (R-Fla),7500,0,7500,Solidly Republican/Conservative,2016
SALMON PAC,Matt Salmon (R-Ariz),7400,0,7400,Solidly Republican/Conservative,2016
KPAC,ex-Sen. Kay Bailey Hutchison (R-Texas),7360,0,7360,Solidly Republican/Conservative,2016
Together United for Liberty Integrity & Prosperity,John Moolenaar (R-Mich),7250,0,7250,Solidly Republican/Conservative,2016
Deep Blue,ex-Rep. Joe Sestak (D-Pa),7200,7200,0,Solidly Democrat/Liberal,2016
Committee to Strengthen America,ex-Rep. Robert E. Andrews (D-NJ),7000,7000,0,Solidly Democrat/Liberal,2016
Jerry's PAC,Jerrold Nadler (D-NY),7000,7000,0,Solidly Democrat/Liberal,2016
Road to Victory PAC,John J Duncan Jr (R-Tenn),7000,0,7000,Solidly Republican/Conservative,2016
Athena PAC,Kathy Castor (D-Fla),7000,7000,0,Solidly Democrat/Liberal,2016
Good Friends PAC,Suzanne Bonamici (D-Ore),7000,7000,0,Solidly Democrat/Liberal,2016
Liberty Fund,Jaime Herrera Beutler (R-Wash),7000,0,7000,Solidly Republican/Conservative,2016
Everybody Counts Everybody Matters PAC,Keith Ellison (D-Minn),7000,7000,0,Solidly Democrat/Liberal,2016
Innovate PAC,Mark Desaulnier (D-Calif),6801,6801,0,Solidly Democrat/Liberal,2016
Oklahoma Strong Leadership PAC,Attorney General Scott Pruitt (R-Okla),6700,0,6700,Solidly Republican/Conservative,2016
Deeds Not Words PAC,Steven Russell (R-Okla),6500,0,6500,Solidly Republican/Conservative,2016
Justice Opportunity Strength Honor PAC,State Treasurer Josh Mandel (R-Ohio),6400,0,6400,Solidly Republican/Conservative,2016
Tipperary Hill PAC,ex-Rep. James T Walsh (R-NY),6250,0,6250,Solidly Republican/Conservative,2016
For Our Republic's Traditions Fund,Jeff Fortenberry (R-Neb),6200,0,6200,Solidly Republican/Conservative,2016
Livable Communities PAC,Raul M Grijalva (D-Ariz),6000,6000,0,Solidly Democrat/Liberal,2016
FAIRPAC,ex-Rep. John Linder (R-GA),6000,0,6000,Solidly Republican/Conservative,2016
Kansafornian PAC,ex-Rep. John Campbell (R-Calif),6000,0,6000,Solidly Republican/Conservative,2016
Leaders Only Unite PAC,Lou Barletta (R-Pa),6000,0,6000,Solidly Republican/Conservative,2016
Make Opportunity PAC,Mo Brooks (R-Ala),6000,0,6000,Solidly Republican/Conservative,2016
Fightin' Ninth PAC,Morgan Griffith (R-VA),5500,0,5500,Solidly Republican/Conservative,2016
GUINTA PAC,Frank Guinta (R-NH),5400,0,5400,Solidly Republican/Conservative,2016
American Liberty & Nation PAC,Alan Nunnelee (R-Miss),5400,0,5400,Solidly Republican/Conservative,2016
Solutions PAC,ex-Rep. Dan Maffei (D-NY),5400,5400,0,Solidly Democrat/Liberal,2016
Cowell For Treasurer,Janet Cowell (D-NC),5200,5200,0,Solidly Democrat/Liberal,2016
Pragmatic Progressive PAC,Shawn O'Connor (D-NH),5000,5000,0,Solidly Democrat/Liberal,2016
Building & Restoring America Together,Dave Brat (R-Va),5000,0,5000,Solidly Republican/Conservative,2016
Health PAC,Dena Minning (D-Fla),5000,5000,0,Solidly Democrat/Liberal,2016
Ready to Work PAC,Sheila Jackson Lee (D-Texas),5000,5000,0,Solidly Democrat/Liberal,2016
Restore Democracy,Rick Nolan (D-Minn),5000,5000,0,Solidly Democrat/Liberal,2016
Three Point Leadership Fund,Curt Clawson (R-Fla),5000,0,5000,Solidly Republican/Conservative,2016
America's Cmte For Excellence,Ralph Abraham (R-La),5000,0,5000,Solidly Republican/Conservative,2016
Advance The Majority PAC,Jeff Miller (R-Fla),5000,0,5000,Solidly Republican/Conservative,2016
Congressional Majority Cmte,ex-Rep. Bill Thomas (R-Calif),5000,0,5000,Solidly Republican/Conservative,2016
New Millennium PAC,Robert Menendez (D-NJ),5000,5000,0,Solidly Democrat/Liberal,2016
Leadership for American Opportunity,Chaka Fattah (D-Pa),5000,5000,0,Solidly Democrat/Liberal,2016
Louise's PAC,Louise M Slaughter (D-NY),5000,5000,0,Solidly Democrat/Liberal,2016
Concerned Americans for Freedom & Opportunity,Adrian Smith (R-Neb),5000,0,5000,Solidly Republican/Conservative,2016
Americans For Legislative Excellence PAC,Alex Mooney (R-WVa),4950,0,4950,Solidly Republican/Conservative,2016
Protecting America Under Law,Paul Gosar (R-Ariz),4750,0,4750,Solidly Republican/Conservative,2016
House Majority Fund,John Lewis (D-Ga),4700,4700,0,Solidly Democrat/Liberal,2016
Good Government for America,ex-Sen. George Allen (R-Va),4506,0,4506,Solidly Republican/Conservative,2016
PITTSPAC,Joe Pitts (R-Pa),4500,0,4500,Solidly Republican/Conservative,2016
GOP Generation Y Fund,Aaron Schock (R-Ill),4000,-1000,5000,Solidly Republican/Conservative,2016
In The Arena PAC,French Hill (R-Ark),4000,0,4000,Solidly Republican/Conservative,2016
Partnership for America,Frank A. LoBiondo (R-NJ),4000,0,4000,Solidly Republican/Conservative,2016
Monadnock PAC,ex-Rep. Charles Bass (R-NH),4000,0,4000,Solidly Republican/Conservative,2016
Big Sky Freedom PAC,ex-Sen. Conrad Burns (R-Mont),3800,0,3800,Solidly Republican/Conservative,2016
National Org to Retain the Majority,ex-Rep. Norm Dicks (D-Wash),3600,3600,0,Solidly Democrat/Liberal,2016
Mike PAC,ex-Rep. Mike Ferguson (R-NJ),3500,0,3500,Solidly Republican/Conservative,2016
Speak Up America PAC,Joe Wilson (R-SC),3000,0,3000,Solidly Republican/Conservative,2016
Truedem Leadership Fund,Marcy Kaptur (D-Ohio),3000,3000,0,Solidly Democrat/Liberal,2016
All Power to The People PAC,Bobby L Rush (D-Ill),3000,3000,0,Solidly Democrat/Liberal,2016
Give Me Liberty PAC,Dana Rohrabacher (R-Calif),3000,0,3000,Solidly Republican/Conservative,2016
BFB PAC,Brendan Boyle (D-Pa),3000,3000,0,Solidly Democrat/Liberal,2016
Blue Power,Don Norcross (D-NJ),3000,3000,0,Solidly Democrat/Liberal,2016
Rebuilding America's Trust PAC,Rob Woodall (R-Ga),3000,0,3000,Solidly Republican/Conservative,2016
MI14,Brenda Lawrence (D-Mich),2700,2700,0,Solidly Democrat/Liberal,2016
Lowcountry Palmetto PAC,Mark Sanford (R-SC),2700,0,2700,Solidly Republican/Conservative,2016
Hudson Valley Future Fund,ex-Rep. Nan Hayworth (R-NY),2700,0,2700,Solidly Republican/Conservative,2016
Daniel Webster PAC,ex-Sen. John E Sununu (R-NH),2513,0,2513,Solidly Republican/Conservative,2016
Patriots In Action,Roger Williams (R-TX),2500,0,2500,Solidly Republican/Conservative,2016
G PAC,Mayor Greg Fischer (D-Louisville),2500,2500,0,Solidly Democrat/Liberal,2016
Dagny PAC,Cynthia Marie Lummis (R-Wyo),2100,0,2100,Solidly Republican/Conservative,2016
Role Model Leadership PAC,Frederica Wilson (D-Fla),2000,2000,0,Solidly Democrat/Liberal,2016
Paragraph Two PAC,Luke Messer (R-Ind),2000,0,2000,Solidly Republican/Conservative,2016
Jimmy Field Campaign,Public Service Commissioner Jimmy Field (R-La),2000,0,2000,Solidly Republican/Conservative,2016
Conservative Leadership Fund,Randy Forbes (R-Va),2000,0,2000,Solidly Republican/Conservative,2016
Majority In Congress PAC,John L Mica (R-Fla),2000,0,2000,Solidly Republican/Conservative,2016
America Forward PAC,John Conyers Jr (D-Mich),2000,2000,0,Solidly Democrat/Liberal,2016
Committee for a Progressive Congress,ex-Rep. David R Obey (D-Wis),2000,2000,0,Solidly Democrat/Liberal,2016
CANDICE-PAC,Candice S. Miller (R-Mich),2000,0,2000,Solidly Republican/Conservative,2016
Committed To Win PAC,Alcee L Hastings (D-Fla),2000,2000,0,Solidly Democrat/Liberal,2016
Virginia Leadership PAC,ex-Rep. Jim Moran (D-VA),1943,0,1943,Solidly Republican/Conservative,2016
Solidarity PAC,ex-Rep. George Miller (D-Calif),1873,1873,0,Solidly Democrat/Liberal,2016
Florida Delivers Leadership PAC,Corrine Brown (D-Fla),1500,1500,0,Solidly Democrat/Liberal,2016
Because Women Can,Bonnie Coleman (D-NJ),1500,1500,0,Solidly Democrat/Liberal,2016
Together PAC,ex-Gov. Deval PatricK (D-Mass),1500,1500,0,Solidly Democrat/Liberal,2016
Better Leadership - Better America,Scott Rigell (R-VA),1500,0,1500,Solidly Republican/Conservative,2016
Prosperity Oklahoma PAC,State Rep. Jon Echols (R-Okla),1250,0,1250,Solidly Republican/Conservative,2016
Democrats Against Waste in Govt PAC,ex-Rep. John Barrow (D-Ga),1250,1250,0,Solidly Democrat/Liberal,2016
Education & Opportunity Fund,ex-Rep. David Wu (D-Ore),1250,1250,0,Solidly Democrat/Liberal,2016
RED PAC,ex-Rep. Adam H Putnam (R-Fla),1099,0,1099,Solidly Republican/Conservative,2016
American Dream PAC,ex-Rep. Henry Bonilla (R-Texas),1000,1000,0,Solidly Democrat/Liberal,2016
New Economy PAC,Brian M. Higgins (D-NY),1000,1000,0,Solidly Democrat/Liberal,2016
Big Red PAC,ex-Rep. Lee Terry (R-Neb),1000,0,1000,Solidly Republican/Conservative,2016
Ponderosa PAC,Mark Amodei (R-Nev),1000,0,1000,Solidly Republican/Conservative,2016
Mahalo PAC,Mark Takai (D-Hawaii),1000,1000,0,Solidly Democrat/Liberal,2016
America's First PAC,Rob Wittman (R-VA),1000,0,1000,Solidly Republican/Conservative,2016
Community PAC,Hank Johnson (D-Ga),1000,1000,0,Solidly Democrat/Liberal,2016
Practical Solutions for America,Mary Perry (R-Nev),900,0,900,Solidly Republican/Conservative,2016
Kentucky Forward PAC,ex-Rep. Ben Chandler (D-Ky),500,500,0,Solidly Democrat/Liberal,2016
Middle Ground PAC,ex-Rep. Timothy Johnson (R-Ill),500,0,500,Solidly Republican/Conservative,2016
Conservatives Organized to Advance Tmrw,Dan Coats (R-Ind),-500,0,-500,Solidly Republican/Conservative,2016
Bringing Leadership Back PAC,Bruce Braley (D-Iowa),-2500,-2500,0,Solidly Democrat/Liberal,2016
