pac_name,affiliate,total,dem,repub,lean,year
Every Republican is Crucial PAC,Eric Cantor (R-Va),1729146,0,1729146,Solidly Republican/Conservative,2010
AmeriPAC: The Fund for a Greater America,Steny H. Hoyer (D-Md),1311950,1291950,20000,Solidly Democrat/Liberal,2010
Freedom Project,John Boehner (R-Ohio),1311750,0,1311750,Solidly Republican/Conservative,2010
BRIDGE PAC,James E. Clyburn (D-SC),1171500,1151500,20000,Solidly Democrat/Liberal,2010
Senate Conservatives Fund,James W DeMint (R-SC),928318,0,928318,Solidly Republican/Conservative,2010
PAC to the Future,Nancy Pelosi (D-Calif),841500,835500,6000,Solidly Democrat/Liberal,2010
Free & Strong America PAC,ex-Gov. Mitt Romney (R-),791995,0,791995,Solidly Republican/Conservative,2010
Victory Now PAC,Chris Van Hollen (D-Md),795500,787500,8000,Solidly Democrat/Liberal,2010
Continuing a Majority Party Action Cmte,Dave Camp (R-Mich),727250,0,727250,Solidly Republican/Conservative,2010
Majority Cmte PAC,Kevin McCarthy (R-Calif),689264,0,689264,Solidly Republican/Conservative,2010
Democrats Win Seats PAC,Debbie Wasserman Schultz (D-Fla),603000,598000,5000,Solidly Democrat/Liberal,2010
Prosperity PAC,Paul Ryan (R-Wis),578500,0,578500,Solidly Republican/Conservative,2010
PETE PAC,Pete Sessions (R-Texas),567000,0,567000,Solidly Republican/Conservative,2010
Growth & Prosperity PAC,Spencer Bachus (R-Ala),506500,0,506500,Solidly Republican/Conservative,2010
SarahPAC,ex-Gov. Sarah Palin (R-Alaska),452000,0,452000,Solidly Republican/Conservative,2010
Bluegrass Cmte,Mitch McConnell (R-Ky),450590,20000,430590,Solidly Republican/Conservative,2010
Next Century Fund,Richard Burr (R-NC),382500,0,382500,Solidly Republican/Conservative,2010
Solidarity PAC,George Miller (D-Calif),386108,386108,0,Solidly Democrat/Liberal,2010
Defend America PAC,Richard C. Shelby (R-Ala),360000,25000,335000,Solidly Republican/Conservative,2010
Senate Majority Fund,Jon L. Kyl (R-Ariz),358000,0,358000,Solidly Republican/Conservative,2010
Alamo PAC,John Cornyn (R-Texas),342500,0,342500,Solidly Republican/Conservative,2010
LA PAC,Henry A. Waxman (D-Calif),359986,359986,0,Solidly Democrat/Liberal,2010
Impact (Schumer),Charles E. Schumer (D-NY),357500,357500,0,Solidly Democrat/Liberal,2010
"Jobs, Economy & Budget Fund",Jeb Hensarling (R-Texas),347500,0,347500,Solidly Republican/Conservative,2010
"Jobs, Opportunities & Education PAC",Joseph Crowley (D-NY),345900,341900,4000,Solidly Democrat/Liberal,2010
OrrinPAC,Orrin G. Hatch (R-Utah),339500,10000,329500,Solidly Republican/Conservative,2010
Forward Together PAC,Mark Warner (D-Va),316500,316500,0,Solidly Democrat/Liberal,2010
GOALPAC,Sander Levin (D-Mich),314000,314000,0,Solidly Democrat/Liberal,2010
Win Back America PAC,Mike Pence (R-Ind),308500,0,308500,Solidly Republican/Conservative,2010
New Millennium PAC,Robert Menendez (D-NJ),308000,308000,0,Solidly Democrat/Liberal,2010
DANPAC,Daniel K Inouye (D-Hawaii),307978,307978,0,Solidly Democrat/Liberal,2010
Synergy PAC,John B. Larson (D-Conn),302000,302000,0,Solidly Democrat/Liberal,2010
Invest in a Strong & Secure America,Darrell Issa (R-Calif),295492,0,295492,Solidly Republican/Conservative,2010
Republican Majority Fund,Saxby Chambliss (R-Ga),276000,5000,271000,Solidly Republican/Conservative,2010
Prairie PAC,Dick Durbin (D-Ill),289250,289250,0,Solidly Democrat/Liberal,2010
Tenn PAC,Lamar Alexander (R-Tenn),269500,15000,254500,Solidly Republican/Conservative,2010
Leadership of Today & Tomorrow,Xavier Becerra (D-Calif),284345,284345,0,Solidly Democrat/Liberal,2010
Country First PAC,John McCain (R-Ariz),273554,0,273554,Solidly Republican/Conservative,2010
Rock City PAC,Bob Corker (R-Tenn),262500,10000,252500,Solidly Republican/Conservative,2010
To Organize a Majority PAC,Tom Harkin (D-Iowa),267000,267000,0,Solidly Democrat/Liberal,2010
21st Century PAC,Buck McKeon (R-Calif),262500,0,262500,Solidly Republican/Conservative,2010
America Works PAC,Sherrod Brown (D-Ohio),258000,258000,0,Solidly Democrat/Liberal,2010
America's Leadership PAC,Deborah Ann Stabenow (D-Mich),254500,254500,0,Solidly Democrat/Liberal,2010
Heartland Values PAC,John Thune (R-SD),236000,0,236000,Solidly Republican/Conservative,2010
Glacier PAC,Max Baucus (D-Mont),247500,247500,0,Solidly Democrat/Liberal,2010
Searchlight Leadership Fund,Harry Reid (D-Nev),237500,237500,0,Solidly Democrat/Liberal,2010
Hawkeye PAC,Chuck Grassley (R-Iowa),225500,0,225500,Solidly Republican/Conservative,2010
Texas Freedom Fund,Joe Barton (R-Texas),234774,0,234774,Solidly Republican/Conservative,2010
New PAC,Devin Nunes (R-Calif),234500,0,234500,Solidly Republican/Conservative,2010
Tallatchee Creek Inc,Jeff Sessions (R-Ala),223500,10000,213500,Solidly Republican/Conservative,2010
DAKPAC,Kent Conrad (D-ND),232000,232000,0,Solidly Democrat/Liberal,2010
We the People PAC,Allyson Schwartz (D-Pa),230600,230600,0,Solidly Democrat/Liberal,2010
Senate Victory Fund,Thad Cochran (R-Miss),225500,0,225500,Solidly Republican/Conservative,2010
First State PAC,Tom Carper (D-Del),220500,220500,0,Solidly Democrat/Liberal,2010
TRUST PAC,Fred Upton (R-Mich),223000,0,223000,Solidly Republican/Conservative,2010
Midwest Values PAC,Al Franken (D-Minn),217500,217500,0,Solidly Democrat/Liberal,2010
Green Mountain PAC,Patrick Leahy (D-Vt),215500,215500,0,Solidly Democrat/Liberal,2010
Dirigo PAC,Susan Collins (R-Maine),200396,5000,195396,Solidly Republican/Conservative,2010
Making Business Excel PAC,Mike Enzi (R-Wyo),210000,0,210000,Solidly Republican/Conservative,2010
Common Values PAC,John A. Barrasso (R-Wyo),203500,0,203500,Solidly Republican/Conservative,2010
Committee for the Preservation of Capitalism,Charles W Boustany Jr (R-La),212065,0,212065,Solidly Republican/Conservative,2010
Committee for a Livable Future,Earl Blumenauer (D-Ore),211500,211500,0,Solidly Democrat/Liberal,2010
Madison PAC (Neal),Richard E. Neal (D-Mass),211000,206000,5000,Solidly Democrat/Liberal,2010
GOP Generation Y Fund,Aaron Schock (R-Ill),209000,0,209000,Solidly Republican/Conservative,2010
Conservative Victory Fund,ex-Rep. Steven D Symms (R-Idaho),207524,0,207524,Solidly Republican/Conservative,2010
Freedom Fund,Mike Crapo (R-Idaho),195000,20000,175000,Solidly Republican/Conservative,2010
M-PAC,Patty Murray (D-Wash),202500,202500,0,Solidly Democrat/Liberal,2010
Help America's Leaders,Hal Rogers (R-Ky),195947,0,195947,Solidly Republican/Conservative,2010
House Conservatives Fund,Patrick McHenry (R-NC),194803,0,194803,Solidly Republican/Conservative,2010
Fund for America's Future,Lindsey Graham (R-SC),189599,0,189599,Solidly Republican/Conservative,2010
Narragansett Bay PAC,Jack Reed (D-RI),193000,193000,0,Solidly Democrat/Liberal,2010
Follow the North Star Fund,Amy Klobuchar (D-Minn),187622,187622,0,Solidly Democrat/Liberal,2010
ROSKAM PAC,Peter Roskam (R-Ill),187071,0,187071,Solidly Republican/Conservative,2010
Fund for the Majority,Dianne Feinstein (D-Calif),185000,185000,0,Solidly Democrat/Liberal,2010
Secure PAC,Bennie G. Thompson (D-Miss),182000,182000,0,Solidly Democrat/Liberal,2010
National Org to Retain the Majority,Norm Dicks (D-Wash),181900,181900,0,Solidly Democrat/Liberal,2010
Jazz PAC,Mary L. Landrieu (D-La),181000,181000,0,Solidly Democrat/Liberal,2010
Long Leaf Pine PAC,Kay R. Hagan (D-NC),179399,179399,0,Solidly Democrat/Liberal,2010
Freedom First PAC,Gov. Tim Pawlenty (R-Minn),175948,0,175948,Solidly Republican/Conservative,2010
Nebraska Leadership PAC,Ben Nelson (D-Neb),177500,177500,0,Solidly Democrat/Liberal,2010
New Republican Majority Fund,ex-Sen. Trent Lott (R-Miss),167400,0,167400,Solidly Republican/Conservative,2010
COLE PAC,Tom Cole (R-Okla),173558,0,173558,Solidly Republican/Conservative,2010
Pioneer PAC,Patrick J. Tiberi (R-Ohio),175000,0,175000,Solidly Republican/Conservative,2010
Prairieland PAC,Michael O. Johanns (R-Neb),174000,0,174000,Solidly Republican/Conservative,2010
21st Century Majority Fund,Johnny Isakson (R-GA),158500,10000,148500,Solidly Republican/Conservative,2010
Majority Initiative-Keep Electing Repubs,Mike Rogers (R-Mich),170016,0,170016,Solidly Republican/Conservative,2010
John S Fund,John M. Shimkus (R-Ill),169000,0,169000,Solidly Republican/Conservative,2010
New Pioneers PAC,Greg Walden (R-Ore),167550,0,167550,Solidly Republican/Conservative,2010
Campaign for Our Country,John Kerry (D-Mass),166500,166500,0,Solidly Democrat/Liberal,2010
KPAC,Kay Bailey Hutchison (R-Texas),160000,0,160000,Solidly Republican/Conservative,2010
Southwest Leadership Fund,Tom Udall (D-NM),164300,164300,0,Solidly Democrat/Liberal,2010
Freedom & Security PAC,John Kline (R-Minn),159000,0,159000,Solidly Republican/Conservative,2010
Fund for a Conservative Future,James M. Inhofe (R-Okla),157500,0,157500,Solidly Republican/Conservative,2010
PAC for a Change,Barbara Boxer (D-Calif),156000,156000,0,Solidly Democrat/Liberal,2010
Victory in November Election PAC,Mike Thompson (D-Calif),155000,153000,2000,Solidly Democrat/Liberal,2010
Leadership in the New Century,Blanche Lincoln (D-Ark),150500,150500,0,Solidly Democrat/Liberal,2010
Leadership 21,John Tanner (D-Tenn),150400,144400,6000,Solidly Democrat/Liberal,2010
TACPAC,Tom Coburn (R-Okla),148000,0,148000,Solidly Republican/Conservative,2010
Rhode Island Hope PAC,Sheldon Whitehouse (D-RI),147500,147500,0,Solidly Democrat/Liberal,2010
Priority PAC,Mark Pryor (D-Ark),147500,147500,0,Solidly Democrat/Liberal,2010
Peak PAC,Mark Udall (D-Colo),146000,146000,0,Solidly Democrat/Liberal,2010
BEAN PAC,Melissa Bean (D-Ill),145000,145000,0,Solidly Democrat/Liberal,2010
Haley's PAC,Gov. Haley Barbour (R-Miss),143000,0,143000,Solidly Republican/Conservative,2010
Mountaineer PAC,Jay Rockefeller (D-WVa),141550,141550,0,Solidly Democrat/Liberal,2010
Leadership for American Opportunity,Chaka Fattah (D-Pa),140000,140000,0,Solidly Democrat/Liberal,2010
Huck PAC,ex-Gov. Mike Huckabee (R-),139967,0,139967,Solidly Republican/Conservative,2010
Advance Arkansas PAC,Mike Ross (D-Ark),139000,137000,2000,Solidly Democrat/Liberal,2010
Wolverine PAC,John D. Dingell (D-Mich),132500,130500,2000,Solidly Democrat/Liberal,2010
SNOWPAC,Robert F. Bennett (R-Utah),126000,0,126000,Solidly Republican/Conservative,2010
Longhorn PAC,Lamar Smith (R-Texas),131500,0,131500,Solidly Republican/Conservative,2010
Building A Majority PAC,Barbara A. Mikulski (D-Md),131000,131000,0,Solidly Democrat/Liberal,2010
Responsibility & Freedom Work PAC,Roger Wicker (R-Miss),131000,0,131000,Solidly Republican/Conservative,2010
Badger PAC,Ron Kind (D-Wis),130000,130000,0,Solidly Democrat/Liberal,2010
Voice for Freedom,Tom Price (R-Ga),124135,0,124135,Solidly Republican/Conservative,2010
CMR PAC,Cathy McMorris Rodgers (R-Wash),124000,0,124000,Solidly Republican/Conservative,2010
Reuniting Our Country PAC,Joe Lieberman (I-Conn),123500,118500,5000,Solidly Democrat/Liberal,2010
Liberty Project,Randy Neugebauer (R-Texas),120000,0,120000,Solidly Republican/Conservative,2010
American Success PAC,David Dreier (R-Calif),117500,0,117500,Solidly Republican/Conservative,2010
Progressive Choices PAC,Jan Schakowsky (D-Ill),113000,113000,0,Solidly Democrat/Liberal,2010
New Jersey First,Frank R Lautenberg (D-NJ),117000,117000,0,Solidly Democrat/Liberal,2010
Preserving America's Traditions,Pat Roberts (R-Kan),107000,0,107000,Solidly Republican/Conservative,2010
Good Government for America,ex-Sen. George Allen (R-Va),110900,0,110900,Solidly Republican/Conservative,2010
Future Leaders PAC,Jerry Lewis (R-Calif),110000,0,110000,Solidly Republican/Conservative,2010
Denali Leadership PAC,Lisa Murkowski (R-Alaska),104500,1000,103500,Solidly Republican/Conservative,2010
Holding Onto Oregon's Priorities,Ron Wyden (D-Ore),107000,107000,0,Solidly Democrat/Liberal,2010
Keep Our Mission PAC,ex-Rep. Dennis Hastert (R-Ill),106000,0,106000,Solidly Republican/Conservative,2010
Protect America's Future PAC,George LeMieux (R-Fla),98500,0,98500,Solidly Republican/Conservative,2010
Harvest PAC,Allen Boyd (D-Fla),99000,96000,3000,Solidly Democrat/Liberal,2010
Wedge PAC,Marsha Blackburn (R-Tenn),97000,0,97000,Solidly Republican/Conservative,2010
All America PAC,Evan Bayh (D-Ind),94816,94816,0,Solidly Democrat/Liberal,2010
Big Tent PAC,Arlen Specter (D-Pa),94425,94425,0,Solidly Democrat/Liberal,2010
Bart's Bridge PAC,Bart Stupak (D-Mich),90000,89000,1000,Solidly Democrat/Liberal,2010
America's Foundation,ex-Sen. Rick Santorum (R-Pa),85000,5000,80000,Solidly Republican/Conservative,2010
Ranger PAC,Geoff Davis (R-Ky),85500,0,85500,Solidly Republican/Conservative,2010
Great Land PAC,Mark Begich (D-Alaska),85500,85500,0,Solidly Democrat/Liberal,2010
Opportunity & Renewal PAC,Jeff Merkley (D-Ore),84600,84600,0,Solidly Democrat/Liberal,2010
Stand Tall America PAC,Mac Thornberry (R-Texas),83500,0,83500,Solidly Republican/Conservative,2010
Democrats Reshaping America,Linda Sanchez (D-Calif),83000,83000,0,Solidly Democrat/Liberal,2010
Mesabi Fund,James L Oberstar (D-Minn),82500,82500,0,Solidly Democrat/Liberal,2010
Fund for American Opportunity,ex-Sen. Spencer Abraham (R-Mich),78300,0,78300,Solidly Republican/Conservative,2010
LEGPAC,Ben Cardin (D-Md),80000,80000,0,Solidly Democrat/Liberal,2010
New York Jobs PAC,Steve Israel (D-NY),78400,78400,0,Solidly Democrat/Liberal,2010
Show-Me Fund,Ike Skelton (D-Mo),76500,76500,0,Solidly Democrat/Liberal,2010
SCOTT PAC,Scott Garrett (R-NJ),76385,0,76385,Solidly Republican/Conservative,2010
Keystone America PAC,Bob Casey (D-Pa),75500,75500,0,Solidly Democrat/Liberal,2010
Good Fund,Bob Goodlatte (R-VA),74224,0,74224,Solidly Republican/Conservative,2010
Valley PAC,Collin C. Peterson (D-Minn),75000,75000,0,Solidly Democrat/Liberal,2010
Taking the Hill PAC,Patrick J. Murphy (D-Pa),74800,74800,0,Solidly Democrat/Liberal,2010
ICE PAC,Erik Paulsen (R-Minn),73400,0,73400,Solidly Republican/Conservative,2010
A New Direction PAC,Jeanne Shaheen (D-NH),73300,73300,0,Solidly Democrat/Liberal,2010
South Dakota First PAC,Tim Johnson (D-SD),73000,73000,0,Solidly Democrat/Liberal,2010
Penguin PAC,Tim Ryan (D-Ohio),73000,73000,0,Solidly Democrat/Liberal,2010
CHRIS PAC,Chris Dodd (D-Conn),73000,73000,0,Solidly Democrat/Liberal,2010
MICHELE PAC,Michele Bachmann (R-Minn),71000,5000,66000,Solidly Republican/Conservative,2010
Moving Phoenix Forward PAC,Mayor Phil Gordon (D-Phoenix),64000,58000,6000,Leans Democrat/Liberal,2010
Rely on Your Beliefs,Roy Blunt (R-Mo),67893,0,67893,Solidly Republican/Conservative,2010
Bringing Leadership Back PAC,Bruce Braley (D-Iowa),66800,66800,0,Solidly Democrat/Liberal,2010
Silver State 21st Century PAC,Shelley Berkley (D-Nev),66700,66700,0,Solidly Democrat/Liberal,2010
13th Colony Leadership Cmte,Jack Kingston (R-Ga),66000,0,66000,Solidly Republican/Conservative,2010
Ohio's Future PAC,ex-Rep. Rob Portman (R-Ohio),66000,0,66000,Solidly Republican/Conservative,2010
Buckeye Patriot PAC,ex-Rep. David Hobson (R-Ohio),65500,0,65500,Solidly Republican/Conservative,2010
For America's Republican Majority,Tom Latham (R-Iowa),62999,0,62999,Solidly Republican/Conservative,2010
Build America PAC,Gregory W. Meeks (D-NY),61525,61525,0,Solidly Democrat/Liberal,2010
Bill PAC (Shuster),Bill Shuster (R-Pa),61500,0,61500,Solidly Republican/Conservative,2010
Missourians for Accountability & Change,Claire McCaskill (D-Mo),61500,61500,0,Solidly Democrat/Liberal,2010
Eye of the Tiger PAC,Steve Scalise (R-La),61150,0,61150,Solidly Republican/Conservative,2010
Keystone Fund,Mike Doyle (D-Pa),61000,61000,0,Solidly Democrat/Liberal,2010
GreggPAC,Gregg Harper (R-Miss),60400,0,60400,Solidly Republican/Conservative,2010
Aloha PAC,Neil Abercrombie (D-Hawaii),59500,59500,0,Solidly Democrat/Liberal,2010
KITPAC,"Christopher ""Kit"" Bond (R-MO)",58129,0,58129,Solidly Republican/Conservative,2010
Competitive Edge PAC,ex-Gov. Janet Napolitano (D-AZ),55000,55000,0,Solidly Democrat/Liberal,2010
National Leadership PAC,Charles B. Rangel (D-NY),55000,55000,0,Solidly Democrat/Liberal,2010
Moving America Forward,Bill Nelson (D-Fla),54500,54500,0,Solidly Democrat/Liberal,2010
Great Plains Leadership Fund,Byron L. Dorgan (D-ND),51543,51543,0,Solidly Democrat/Liberal,2010
Great American Fund,Dan Boren (D-Okla),50000,50000,0,Solidly Democrat/Liberal,2010
Majority PAC (Murtha),John P. Murtha (D-Pa),50000,50000,0,Solidly Democrat/Liberal,2010
Committee for a Democratic Future,Rosa L DeLauro (D-Conn),49000,49000,0,Solidly Democrat/Liberal,2010
Leadership that Listens PAC,Donna Edwards (D-Md),49000,49000,0,Solidly Democrat/Liberal,2010
Betty PAC,Betty McCollum (D-Minn),48000,48000,0,Solidly Democrat/Liberal,2010
Lone Star Leadership PAC,Michael Burgess (R-Texas),47350,0,47350,Solidly Republican/Conservative,2010
Moderate Victory Fund,Dennis Cardoza (D-Calif),47000,47000,0,Solidly Democrat/Liberal,2010
Treasure State PAC,Jon Tester (D-Mont),46934,46934,0,Solidly Democrat/Liberal,2010
Dutch PAC,Dutch Ruppersberger (D-Md),46800,44800,2000,Solidly Democrat/Liberal,2010
Vote to Elect Republicans Now PAC,Vernon Buchanan (R-Fla),41500,0,41500,Solidly Republican/Conservative,2010
Virginia Leadership PAC,Jim Moran (D-VA),46200,46200,0,Solidly Democrat/Liberal,2010
CONA PAC,Mike Conaway (R-Texas),45800,0,45800,Solidly Republican/Conservative,2010
3rd & Long,Heath Shuler (D-NC),45100,45100,0,Solidly Democrat/Liberal,2010
Louisiana Values PAC,John Fleming (R-La),43000,0,43000,Solidly Republican/Conservative,2010
People's House PAC,Tammy Baldwin (D-Wis),45000,45000,0,Solidly Democrat/Liberal,2010
America Forward PAC,John Conyers Jr (D-Mich),45000,45000,0,Solidly Democrat/Liberal,2010
New Apollo Energy,Jay Inslee (D-Wash),45000,45000,0,Solidly Democrat/Liberal,2010
Hispanic Unity USA,Loretta Sanchez (D-CA),45000,45000,0,Solidly Democrat/Liberal,2010
Mike PAC,Mike Ferguson (R-NJ),43750,0,43750,Solidly Republican/Conservative,2010
HERGER PAC,Wally Herger (R-Calif),43090,0,43090,Solidly Republican/Conservative,2010
MINT PAC,James W DeMint (R-SC),42500,0,42500,Solidly Republican/Conservative,2010
House Majority Fund,John Lewis (D-Ga),42000,42000,0,Solidly Democrat/Liberal,2010
CANDICE-PAC,Candice S. Miller (R-Mich),42000,0,42000,Solidly Republican/Conservative,2010
Help Elect America's Team PAC,Kendrick B Meek (D-Fla),40300,40300,0,Solidly Democrat/Liberal,2010
Freedom PAC (Broun),Paul Broun Jr (R-GA),40200,0,40200,Solidly Republican/Conservative,2010
Democrats Against Waste in Govt PAC,John Barrow (D-Ga),39000,39000,0,Solidly Democrat/Liberal,2010
Reenergizing Our Nation PAC,Ron Klein (D-Fla),38500,38500,0,Solidly Democrat/Liberal,2010
SkiPAC,Jim Matheson (D-Utah),38200,38200,0,Solidly Democrat/Liberal,2010
CARTER PAC,John Carter (R-Texas),37000,0,37000,Solidly Republican/Conservative,2010
Silk PAC,Bill Pascrell Jr (D-NJ),37000,37000,0,Solidly Democrat/Liberal,2010
Restore America PAC,Sam Brownback (R-Kan),36500,0,36500,Solidly Republican/Conservative,2010
Shore PAC,Frank Pallone Jr (D-NJ),36000,36000,0,Solidly Democrat/Liberal,2010
Louisiana Reform PAC,David Vitter (R-LA),36000,0,36000,Solidly Republican/Conservative,2010
Texas First PAC,Henry Cuellar (D-Texas),36000,36000,0,Solidly Democrat/Liberal,2010
Arch Leadership PAC,Russ Carnahan (D-Mo),35500,35500,0,Solidly Democrat/Liberal,2010
People Helping Illinois Lead PAC,Phil Hare (D-Ill),35200,35200,0,Solidly Democrat/Liberal,2010
Progressive Voters of America,Bernie Sanders (I-Vt),35000,35000,0,Solidly Democrat/Liberal,2010
MISSION PAC,Lois Capps (D-Calif),34400,34400,0,Solidly Democrat/Liberal,2010
Leadership Empowerment & Development PAC,Charlie A. Gonzalez (D-Texas),33800,33800,0,Solidly Democrat/Liberal,2010
Majority In Congress PAC,John L Mica (R-Fla),33500,0,33500,Solidly Republican/Conservative,2010
Born Fighting PAC,James Webb (D-Va),33004,33004,0,Solidly Democrat/Liberal,2010
SAC PAC,Doris O Matsui (D-Calif),33000,33000,0,Solidly Democrat/Liberal,2010
Brave PAC,David Scott (D-Ga),32900,30900,2000,Solidly Democrat/Liberal,2010
United for A Strong America,Adam Schiff (D-Calif),31860,31860,0,Solidly Democrat/Liberal,2010
American Solutions PAC,ex-Rep. Newt Gingrich (R-Ga),32149,0,32149,Solidly Republican/Conservative,2010
Progressive Patriots Fund,Russ Feingold (D-Wis),31000,31000,0,Solidly Democrat/Liberal,2010
PR Democracy,Pedro Pierluisi (3-PR),30800,30800,0,Solidly Democrat/Liberal,2010
GWEN PAC,Gwen Moore (D-Wis),30500,30500,0,Solidly Democrat/Liberal,2010
Congressional Majority Cmte,ex-Rep. Bill Thomas (R-Calif),27900,0,27900,Solidly Republican/Conservative,2010
Ocean State PAC,Jim Langevin (D-RI),30250,30250,0,Solidly Democrat/Liberal,2010
Livable Communities PAC,Raul M Grijalva (D-Ariz),30000,30000,0,Solidly Democrat/Liberal,2010
New Vision America Fund,Mike Honda (D-Calif),30000,30000,0,Solidly Democrat/Liberal,2010
Renewing the American Dream PAC,Tim Walz (D-Minn),30000,30000,0,Solidly Democrat/Liberal,2010
JJJ PAC,Betty Sue Sutton (D-Ohio),30000,30000,0,Solidly Democrat/Liberal,2010
Southwest Pennsylvania PAC,Jason Altmire (D-Pa),29900,29900,0,Solidly Democrat/Liberal,2010
Kentucky Forward PAC,Ben Chandler (D-Ky),29800,29800,0,Solidly Democrat/Liberal,2010
Trans PAC,Steve LaTourette (R-Ohio),29300,0,29300,Solidly Republican/Conservative,2010
Together for Our Majority,ex-Rep. Tom Reynolds (R-NY),29150,2000,27150,Solidly Republican/Conservative,2010
Jerry's PAC,Jerrold Nadler (D-NY),29000,29000,0,Solidly Democrat/Liberal,2010
BRETTPAC,Brett Guthrie (R-Ky),28900,0,28900,Solidly Republican/Conservative,2010
Florida Delivers Leadership PAC,Corrine Brown (D-Fla),28750,28750,0,Solidly Democrat/Liberal,2010
Southern California Fund,Brad Sherman (D-Calif),28600,28600,0,Solidly Democrat/Liberal,2010
Acton PAC,Lynn A. Westmoreland (R-Ga),28600,0,28600,Solidly Republican/Conservative,2010
Road to Freedom PAC,Ed Royce (R-Calif),28000,0,28000,Solidly Republican/Conservative,2010
Southern Prosperity in Opportunity PAC,Solomon P Ortiz (D-Texas),27600,27600,0,Solidly Democrat/Liberal,2010
DOC PAC,Phil Gingrey (R-Ga),27250,0,27250,Solidly Republican/Conservative,2010
Calumet PAC,Pete Visclosky (D-Ind),27000,27000,0,Solidly Democrat/Liberal,2010
White Mountain PAC,Judd Gregg (R-NH),26000,0,26000,Solidly Republican/Conservative,2010
Committee for Leadership & Progress,Nita M. Lowey (D-NY),26000,26000,0,Solidly Democrat/Liberal,2010
Mary's PAC,Mary Bono Mack (R-Calif),25500,0,25500,Solidly Republican/Conservative,2010
Progress PAC,Nydia M. Velazquez (D-NY),25500,25500,0,Solidly Democrat/Liberal,2010
Empire PAC,Kirsten Gillibrand (D-NY),25400,25400,0,Solidly Democrat/Liberal,2010
Right Track PAC,Marion Berry (D-Ark),25300,25300,0,Solidly Democrat/Liberal,2010
Leading Us In Success PAC,ex-Del. Luis Fortuno (R-PR),24000,0,24000,Solidly Republican/Conservative,2010
Cactus PAC,Ed Pastor (D-Ariz),25000,25000,0,Solidly Democrat/Liberal,2010
OCPAC,John Campbell (R-Calif),24497,0,24497,Solidly Republican/Conservative,2010
Tipperary Hill PAC,ex-Rep. James T Walsh (R-NY),24200,0,24200,Solidly Republican/Conservative,2010
Concerned Americans for Freedom & Opportunity,Adrian Smith (R-Neb),24000,0,24000,Solidly Republican/Conservative,2010
Spud PAC,ex-Rep. John Salazar (D-CO),23500,23500,0,Solidly Democrat/Liberal,2010
Mill to the Hill PAC,Mike Michaud (D-Maine),23500,23500,0,Solidly Democrat/Liberal,2010
3T PAC,Nick Rahall (D-WVa),23179,23179,0,Solidly Democrat/Liberal,2010
BOSPAC,Leonard L Boswell (D-Iowa),22600,22600,0,Solidly Democrat/Liberal,2010
SecureUS,Jane Harman (D-Calif),22600,22600,0,Solidly Democrat/Liberal,2010
John J Cullerton Federal Cmte,State Sen. John J. Cullerton (D-Ill),22600,22600,0,Solidly Democrat/Liberal,2010
Empowering Each Community PAC,Elijah E. Cummings (D-Md),22474,22474,0,Solidly Democrat/Liberal,2010
GeorgiaPAC,Jim Marshall (D-Ga),22000,22000,0,Solidly Democrat/Liberal,2010
Freedom & Democracy Fund,Mel Martinez (R-Fla),16000,0,16000,Leans Republican/Conservative,2010
Ohio USA PAC,George V Voinovich (R-Ohio),20000,0,20000,Solidly Republican/Conservative,2010
March for Progress,Edward M. Kennedy (D-Mass),21000,21000,0,Solidly Democrat/Liberal,2010
People's PAC,Lynn Woolsey (D-Calif),21000,21000,0,Solidly Democrat/Liberal,2010
Carolyn's PAC,Carolyn B. Maloney (D-NY),20500,20500,0,Solidly Democrat/Liberal,2010
Battle Born PAC,John Ensign (R-Nev),20000,0,20000,Solidly Republican/Conservative,2010
Eureka PAC,Ken Calvert (R-Calif),20000,0,20000,Solidly Republican/Conservative,2010
Committee for Southwest Virginia,Rick Boucher (D-Va),19899,19899,0,Solidly Democrat/Liberal,2010
Spirit Fund,Cliff Stearns (R-Fla),19500,0,19500,Solidly Republican/Conservative,2010
Thoroughbred PAC,Ed Whitfield (R-Ky),19000,0,19000,Solidly Republican/Conservative,2010
ANSWER PAC,John Hall (D-NY),19000,19000,0,Solidly Democrat/Liberal,2010
Citizens for Action,Paul E. Kanjorski (D-PA),18000,18000,0,Solidly Democrat/Liberal,2010
Committee for a Progressive Congress,David R Obey (D-Wis),18000,18000,0,Solidly Democrat/Liberal,2010
Individuals Dedicated to Ethics & Science,Diana DeGette (D-Colo),17838,17838,0,Solidly Democrat/Liberal,2010
Northstar Leadership PAC,ex-Sen. Norm Coleman (R-Minn),17500,0,17500,Solidly Republican/Conservative,2010
Common Sense Common Solutions,Kay Granger (R-Texas),17500,0,17500,Solidly Republican/Conservative,2010
Husky PAC,Joe Courtney (D-Conn),17500,17500,0,Solidly Democrat/Liberal,2010
Liberty PAC (Ron Paul),Ron Paul (R-Texas),17220,0,17220,Solidly Republican/Conservative,2010
Best PAC,Silvestre Reyes (D-Texas),17000,17000,0,Solidly Democrat/Liberal,2010
Millenium Leadership PAC,Alcee L Hastings (D-Fla),16300,16300,0,Solidly Democrat/Liberal,2010
EDPAC,Edwin G Perlmutter (D-Colo),16000,16000,0,Solidly Democrat/Liberal,2010
Sharp Pencil PAC,Howard Coble (R-NC),16000,0,16000,Solidly Republican/Conservative,2010
Our Future PAC,Bart Gordon (D-Tenn),15800,14800,1000,Solidly Democrat/Liberal,2010
All Power to The People PAC,Bobby L Rush (D-Ill),15400,15400,0,Solidly Democrat/Liberal,2010
American Security PAC,Mike D. Rogers (R-Ala),15000,0,15000,Solidly Republican/Conservative,2010
ANDER PAC,Ander Crenshaw (R-Fla),15000,0,15000,Solidly Republican/Conservative,2010
Come Back PAC,Tim Murphy (R-Pa),14500,0,14500,Solidly Republican/Conservative,2010
Motivating Energetic Leadership PAC,Melvin L. Watt (D-NC),14000,14000,0,Solidly Democrat/Liberal,2010
DENT PAC,Charlie Dent (R-Pa),14000,0,14000,Solidly Republican/Conservative,2010
TEX-USA Fund,Chet Edwards (D-Texas),14000,14000,0,Solidly Democrat/Liberal,2010
Heart PAC,Todd Tiahrt (R-Kan),13000,0,13000,Solidly Republican/Conservative,2010
Tidewater PAC,Glenn Nye (D-Va),14000,14000,0,Solidly Democrat/Liberal,2010
GOLD PAC,Sanford D Bishop Jr (D-Ga),13900,13900,0,Solidly Democrat/Liberal,2010
Conservative Principles PAC,Steven A. King (R-Iowa),13500,0,13500,Solidly Republican/Conservative,2010
Pono PAC,Daniel K. Akaka (D-Hawaii),13400,13400,0,Solidly Democrat/Liberal,2010
Eisenhower PAC,Jerry Moran (R-Kan),12400,0,12400,Solidly Republican/Conservative,2010
Pioneer PAC (Rob Bishop),Rob Bishop (R-Utah),12500,0,12500,Solidly Republican/Conservative,2010
I-PAC,David Loebsack (D-Iowa),12200,12200,0,Solidly Democrat/Liberal,2010
One Voice,Barbara Lee (D-Calif),12000,12000,0,Solidly Democrat/Liberal,2010
Vision for Tomorrow Fund,John Linder (R-Ga),12000,0,12000,Solidly Republican/Conservative,2010
Leadership for America's Future,John Shadegg (R-Ariz),10000,0,10000,Leans Republican/Conservative,2010
Serving with a Mainstream Perspective PAC,Charles Melancon (D-La),11650,10650,1000,Solidly Democrat/Liberal,2010
CAP PAC,Carolyn McCarthy (D-NY),11500,11500,0,Solidly Democrat/Liberal,2010
JOEPAC,Joe Pitts (R-Pa),11000,0,11000,Solidly Republican/Conservative,2010
Daniel Webster PAC,ex-Sen. John E Sununu (R-NH),11000,0,11000,Solidly Republican/Conservative,2010
Lincoln PAC,Mark Kirk (R-Ill),11000,0,11000,Solidly Republican/Conservative,2010
Serving America's Citizens PAC,Dan Lungren (R-Calif),10800,0,10800,Solidly Republican/Conservative,2010
Rough Rider PAC,ex-Rep. Rick A Lazio (R-NY),10599,0,10599,Solidly Republican/Conservative,2010
Progressive Americans for Democracy,Peter DeFazio (D-Ore),10500,10500,0,Solidly Democrat/Liberal,2010
First Team PAC,Tom Rooney (R-Fla),10500,0,10500,Solidly Republican/Conservative,2010
Renew Ohio PAC,Zachary Space (D-Ohio),10250,10250,0,Solidly Democrat/Liberal,2010
MURPHPAC,Chris Murphy (D-Conn),10000,10000,0,Solidly Democrat/Liberal,2010
Reaching for a Brighter America PAC,Robert B. Aderholt (R-Ala),10000,0,10000,Solidly Republican/Conservative,2010
RED PAC,Adam H Putnam (R-Fla),10000,0,10000,Solidly Republican/Conservative,2010
Sunshine PAC,ex-Rep. E Clay Shaw Jr. (R-Fla),10000,0,10000,Solidly Republican/Conservative,2010
Rocky Mountain PAC,ex-Sen. Ken Salazar (D-Colo),9796,9796,0,Solidly Democrat/Liberal,2010
Defending America's Future,Trent Franks (R-Ariz),9500,0,9500,Solidly Republican/Conservative,2010
DIMEPAC,Ginny Brown-Waite (R-Fla),9074,0,9074,Solidly Republican/Conservative,2010
Innovation Fund,Scott Murphy (D-NY),9000,9000,0,Solidly Democrat/Liberal,2010
ChutzPAC,Howard L Berman (D-Calif),9000,9000,0,Solidly Democrat/Liberal,2010
Rhode Island PAC,Patrick J. Kennedy (D-RI),8500,8500,0,Solidly Democrat/Liberal,2010
NODAK PAC,Earl Pomeroy (D-ND),8500,8500,0,Solidly Democrat/Liberal,2010
United for Progress Leadership Cmte,Jerry F. Costello (D-Ill),8300,8300,0,Solidly Democrat/Liberal,2010
Transfund PAC,Carolyn Cheeks Kilpatrick (D-Mich),10200,10200,0,Solidly Democrat/Liberal,2010
DEBPAC,Deborah Halvorson (D-Ill),8200,8200,0,Solidly Democrat/Liberal,2010
Forging the Future Fund,Donald M. Payne (D-NJ),8200,8200,0,Solidly Democrat/Liberal,2010
Mass PAC,Michael E Capuano (D-Mass),8000,8000,0,Solidly Democrat/Liberal,2010
Buckeye Liberty PAC,Jim Jordan (R-Ohio),8000,0,8000,Solidly Republican/Conservative,2010
SCIPAC,Vernon J. Ehlers (R-Mich),7500,0,7500,Solidly Republican/Conservative,2010
People Helping People,Maxine Waters (D-Calif),7500,7500,0,Solidly Democrat/Liberal,2010
Rural America Policy Cmte,Stephanie Herseth Sandlin (D-SD),7500,7500,0,Solidly Democrat/Liberal,2010
Badger Fund,Tom Petri (R-Wis),7500,0,7500,Solidly Republican/Conservative,2010
Sawtooth PAC,Mike Simpson (R-Idaho),7400,0,7400,Solidly Republican/Conservative,2010
Riptide PAC,Brian P. Bilbray (R-Calif),7000,0,7000,Solidly Republican/Conservative,2010
California Aggressive Leadership PAC,Joe Baca (D-Calif),7000,7000,0,Solidly Democrat/Liberal,2010
Champions of American Freedom PAC,Thad McCotter (R-Mich),6917,0,6917,Solidly Republican/Conservative,2010
Accountability PAC,Bill Posey (R-Fla),6800,0,6800,Solidly Republican/Conservative,2010
Arkansas for Leadership,John Boozman (R-Ark),6800,0,6800,Solidly Republican/Conservative,2010
Prosperity Helps Inspire Liberty PAC,ex-Rep. Phil English (R-Pa),6500,1000,5500,Leans Republican/Conservative,2010
Vision for America PAC,Jackie Speier (D-Calif),6500,6500,0,Solidly Democrat/Liberal,2010
Jean A Carnahan PAC,ex-Sen. Jean Carnahan (D-Mo),6326,6326,0,Solidly Democrat/Liberal,2010
Moderates for America PAC,Michael Arcuri (D-NY),6130,6130,0,Solidly Democrat/Liberal,2010
Taking Our Majority PAC,Tom McClintock (R-Calif),6000,0,6000,Solidly Republican/Conservative,2010
Education & Opportunity Fund,David Wu (D-Ore),6000,6000,0,Solidly Democrat/Liberal,2010
"Renewing Opportunity, Trust & Hope",Steven R. Rothman (D-NJ),6000,6000,0,Solidly Democrat/Liberal,2010
Leadership Circle PAC,ex-Sen. Elizabeth Dole (R-NC),5500,0,5500,Solidly Republican/Conservative,2010
Building Our Opportunities Together PAC,Denny Rehberg (R-Mont),5000,0,5000,Solidly Republican/Conservative,2010
Palmetto PAC,John M Spratt Jr (D-SC),5000,5000,0,Solidly Democrat/Liberal,2010
BARTLETT PAC,Roscoe G Bartlett (R-Md),5000,0,5000,Solidly Republican/Conservative,2010
Summit PAC,Alan B Mollohan (D-Wva),5000,5000,0,Solidly Democrat/Liberal,2010
Promoting Republicans You Can Elect,ex-Rep. Deborah Pryce (R-Ohio),5000,0,5000,Solidly Republican/Conservative,2010
Restore Our Democracy PAC,Rodney Alexander (R-La),5000,0,5000,Solidly Republican/Conservative,2010
Winpac,Diane E Watson (D-Calif),5000,5000,0,Solidly Democrat/Liberal,2010
Takin Back America,Todd Akin (R-Mo),5000,0,5000,Solidly Republican/Conservative,2010
GUTS,Alan Grayson (D-Fla),4800,4800,0,Solidly Democrat/Liberal,2010
Fund for a Responsible Future,ex-Rep. Thomas J Bliley Jr (R-Va),4634,0,4634,Solidly Republican/Conservative,2010
Harris County Conservative Cong Campaign,John M Faulk (R-Texas),4250,0,4250,Solidly Republican/Conservative,2010
Political Hall of Fame PAC,Jim Bunning (R-Ky),4049,0,4049,Solidly Republican/Conservative,2010
For Our Republic's Traditions Fund,Jeff Fortenberry (R-Neb),4000,0,4000,Solidly Republican/Conservative,2010
Bob Barr Leadership Fund,ex-Rep. Bob Barr (R-Ga),0,0,0,On the fence,2010
Storm Chasers,Steve Buyer (R-Ind),4000,0,4000,Solidly Republican/Conservative,2010
Middle Class America PAC,Daniel Lipinski (D-Ill),4000,4000,0,Solidly Democrat/Liberal,2010
Dunn PAC,ex-Rep. Jennifer Dunn (R-Wa),3596,0,3596,Solidly Republican/Conservative,2010
Speak Up America PAC,Joe Wilson (R-SC),3500,0,3500,Solidly Republican/Conservative,2010
Deep Blue,Joe Sestak (D-Pa),3400,3400,0,Solidly Democrat/Liberal,2010
Jack PAC,ex-Rep. Jack Quinn (R-NY),3250,0,3250,Solidly Republican/Conservative,2010
Hoosier PAC,Dan Burton (R-Ind),3000,0,3000,Solidly Republican/Conservative,2010
American Leadership Council,ex-Rep. Joe Knollenberg (R-Mich),2600,0,2600,Solidly Republican/Conservative,2010
Victory PAC,C. W. Bill Young (R-Fla),2500,0,2500,Solidly Republican/Conservative,2010
"Progress, Vision & Commitment",Lt. Gov. Diane Denish (D-NM),2500,2500,0,Solidly Democrat/Liberal,2010
IRL PAC,Ileana Ros-Lehtinen (R-Fla),2500,0,2500,Solidly Republican/Conservative,2010
Sheriff PAC,Dave Reichert (R-Wash),2500,0,2500,Solidly Republican/Conservative,2010
GOJO PAC,Jo Ann Emerson (R-Mo),2000,0,2000,Solidly Republican/Conservative,2010
Hermanator PAC,Herman Cain (R-),2000,0,2000,Solidly Republican/Conservative,2010
Keystone PAC,Jim Gerlach (R-Pa),2000,0,2000,Solidly Republican/Conservative,2010
Freedom Security Prosperity PAC,Connie Mack (R-Fla),2000,0,2000,Solidly Republican/Conservative,2010
Truedem Leadership Fund,Marcy Kaptur (D-Ohio),2000,2000,0,Solidly Democrat/Liberal,2010
National Democratic Policy Cmte,Lyndon H LaRouche Jr (D),2000,2000,0,Solidly Democrat/Liberal,2010
Attain the Majority PAC,Jeff Miller (R-Fla),2000,0,2000,Solidly Republican/Conservative,2010
Road to Victory PAC,John J Duncan Jr (R-Tenn),1750,0,1750,Solidly Republican/Conservative,2010
American Dream PAC,ex-Rep. Henry Bonilla (R-Texas),1524,0,1524,Solidly Republican/Conservative,2010
Freshman 50,Brian Allan Miller (R-Ariz),1500,0,1500,Solidly Republican/Conservative,2010
Federal Victory Fund,ex-Rep. Tom Davis (R-Va),1496,0,1496,Solidly Republican/Conservative,2010
ZackPAC,Robert Wexler (D-Fla),1000,1000,0,Solidly Democrat/Liberal,2010
Mountain Leadership PAC,ex-Rep. Charles H Taylor (R-NC),1000,0,1000,Solidly Republican/Conservative,2010
Palmetto Freedom PAC,Gresham Barrett (R-SC),1000,0,1000,Solidly Republican/Conservative,2010
Mac PAC,James P McGovern (D-Mass),1000,1000,0,Solidly Democrat/Liberal,2010
Western Values PAC,Mike Coffman (R-Colo),1000,0,1000,Solidly Republican/Conservative,2010
Building Leadership & Inspiring New Enterprise,Blaine Luetkemeyer (R-Mo),1000,0,1000,Solidly Republican/Conservative,2010
Leadership for the Future,ex-Sen. Jim Sasser (D-Tenn),700,700,0,Solidly Democrat/Liberal,2010
New Leadership PAC,Felton Newell (D-Calif),600,600,0,Solidly Democrat/Liberal,2010
Three Rivers PAC,Kurt Schrader (D-Ore),500,500,0,Solidly Democrat/Liberal,2010
No Retreat PAC,Duncan D. Hunter (R-Calif),500,0,500,Solidly Republican/Conservative,2010
New South Leadership PAC,G K Butterfield (D-NC),500,500,0,Solidly Democrat/Liberal,2010
Changing Tide Cmte,ex-Sen. Wayne Allard (R-Colo),500,0,500,Solidly Republican/Conservative,2010
Midnight Sun,Don Young (R-Alaska),-500,0,-500,Solidly Republican/Conservative,2010
Northern Lights PAC,ex-Sen. Ted Stevens (R-Alaska),-4000,0,-4000,Solidly Republican/Conservative,2010
Solutions America,ex-Mayor Rudolph W Giuliani (R-NYC),-1000,0,-1000,Solidly Republican/Conservative,2010
Our Common Values PAC,ex-Rep. Rahm Emanuel (D-Ill),-19500,-21500,2000,Solidly Democrat/Liberal,2010
